its my job	é o meu trabalho
wholl cook	quem cozinhará
help me	ajudemme
i sat down	eu me sentei
im worn out	estou exausto
dogs can swim	cachorros nadam
lets start	comecemos
we have some	temos algum
lets swim	nademos
may i smoke	posso fumar
look here	olhe aqui
i was wrong	eu errei
tom grumbled	tom resmungou
ill sing	cantarei
is that all	isso é tudo
youve tried	vocês tentaram
i try	tento
hes so young	ele é tão jovem
im a hero	eu sou uma heroína
were mature	somos maduros
did tom swim	o tom nadou
she needs it	ela precisa disso
have some tea	beba um pouco de chá
im a baker	eu sou padeiro
lets play	vamos jogar
toms unsure	o tom está em dúvida
this works	isto funciona
youre right	você tem razão
beat it	vaza
you tried	vocês tentaram
dont tell me	não me fale
we hate tom	nós odiamos tom
its awesome	é demais
is this true	isto é verdade
i will obey	obedecerei
tom hates tv	o tom detesta tv
be sensible	tem bom senso
are you new	vocês são novos
come on in	entre
he turned	ele fez dezesseis
they hate me	me odeiam
im small	eu sou pequeno
is it rainy	o tempo está chuvoso
im at work	eu estou no trabalho
i drank milk	bebi leite
youre nuts	estás doido
dont cheat	não cole
dont do this	não faça isso
tom wants it	o tom quer isso
forget it	esqueça
tom gave up	tom desistiu
keep digging	continue cavando
im a man	eu sou homem
come on	qual é
were shy	somos tímidos
he is happy	ele está feliz
you can come	vocês podem vir
get up	levantese
im involved	eu estou envolvido
are you free	você está livre
tom hurt me	tom me machucou
please leave	vá embora por favor
follow us	siganos
i am a runner	eu sou corredor
aim higher	mire mais alto
im brave	eu sou corajoso
he has braces	ele usa aparelho
i understand	eu compreendo
he is cranky	ele é ranzinza
it was weird	foi estranho
is it cloudy	está nublado
i lost it	eu o perdi
i saw one	eu vi um
i did my best	fiz o melhor que me foi possível
i do like tom	eu gosto muito do tom
jesus wept	jesus chorou
im starving	estou morrendo de fome
ill ask tom	eu irei perguntar ao tom
youre old	tu és velho
i heard you	eu te escutei
dont smile	não sorria
look back	olhe para trás
excuse me	o quê
was it fun	foi divertido
we found it	nós encontramos
just relax	apenas relaxe
be reasonable	seja razoável
i was lucky	eu tive sorte
i will wait	eu vou esperar
that hurts	isso machuca
is that it	é isso
tom slipped	tom escorregou
i didnt know	eu não sabia
come quickly	venha rápido
is that mine	essa é a minha
i liked it	eu gostei
let tom rest	deixe tom descansar
i left tom	eu deixei tom
get upstairs	subam
ill go back	eu vou voltar
i am human	eu sou humano
im so sorry	eu sinto muito
you drive	você dirige
its huge	é enorme
dont be sad	não fique triste
hes not sick	ele não está enfermo
are they gone	elas se foram
is he right	ele está certo
they won	elas ganharam
im in paris	eu estou em paris
tom shrugged	tom deu de ombros
i tried	tentei
never mind	não se preocupe
talk to me	fale comigo
i am happy	me sinto feliz
i had fun	eu me diverti
shut up	calate
no one knows	ninguém sabe
are you rich	você é rico
it was wet	estava molhado
were strong	nós somos fortes
he is eating	está comendo
tom lost	o tom perdeu
did you help	você ajudou
dont speak	não falem
bring backup	traga reforços
i will try	eu tentarei
they danced	eles dançaram
i like women	eu gosto de mulheres
i knew that	eu sabia disso
i came alone	eu vim sozinho
youre needy	você está carente
they cheered	eles aplaudiram
i like you	gosto de você
birds fly	pássaros voam
i am coming	estou vindo
i wont go	não irei
how about you	e você
stop reading	pare de ler
tom insisted	tom insistiu
well drive	nós vamos dirigir
i do want it	eu quero muito isso
im not tall	não sou alto
welcome	seja bemvinda
toms glad	tom está contente
of course	claro
i am eating	eu estou comendo
ill see tom	eu vou ver o tom
well follow	nós seguiremos
it works	funciona
read this	leiam isso
youre fools	vocês são otários
im sorry	desculpa
they crashed	elas colidiram
were awake	nós estamos acordados
war is evil	a guerra é má
ill leave	eu vou embora
tom has come	o tom veio
i like both	eu gosto de ambos
theyre home	eles estão em casa
are we lost	estamos perdidos
well share	nós compartilharemos
dont run	não corra
im inside	estou dentro
are you fat	você é gordo
forget tom	esqueçam o tom
tom swims	tom nada
im a woman	eu sou mulher
who did that	quem foi que fez isso
im with him	estou com ele
leave us	deixenos
well scream	nós iremos gritar
calm down	aquieta o facho
please wait	espere por favor
tom broke it	tom quebrouo
look out	cuidado
forgive tom	perdoem o tom
i am japanese	sou japonês
we know that	nós sabemos disso
are they gone	eles foram embora
i need sugar	eu preciso de açúcar
come alone	venha sozinho
a car went by	um carro passou
please stop	pare por favor
we have hope	temos esperança
relax	relaxa
let me swim	deixeme nadar
please sing	por favor cante
please come	venha por favor
well start	iremos começar
i will go	eu vou
i want to go	quero ir
we sat down	nós nos sentamos
i miss you	saudades
i ate a donut	eu comi uma rosquinha
here he is	aqui está ele
nobody cares	ninguém está nem aí
i woke up	eu acordei
ill stop	eu vou parar
toms weird	o tom está estranho
is tom lost	o tom está perdido
any questions	alguma pergunta
sit there	senta aí
get upstairs	sobe
see you	até logo
i dont cry	eu não choro
who spoke	quem falou
theyll fail	elas fracassarão
youre small	tu és pequeno
toms awake	o tom está acordado
has tom come	tom veio
ask around	perguntem por aí
look closer	olhe mais de perto
i love you	eu o amo
ask tom again	pergunte mais uma vez ao tom
i am eating	estou comendo
i saw a dog	vi um cachorro
well go	nós iremos
can i come	posso vir
tom sneezed	tom espirrou
we lost	perdemos
dont let go	não solta
thats weird	isso é esquisito
take it	pegueo
say hello	cumprimenta
welcome	bemvindo
were better	nós estamos melhor
excuse me	desculpa
we got lost	enganámonos no caminho
excuse me	desculpe
i can be good	eu posso ser bom
she was busy	ela estava ocupada
is it hot	está calor
im scared	estou assustado
please sing	cantem por favor
i am american	eu sou americano
its	são
was it cold	estava fazendo frio
thats mine	é minha
stop yelling	pare de gritar
are you fit	você está em forma
tom retired	tom se aposentou
im finished	já terminei
hows school	como vai a escola
im standing	eu estou de pé
well share	compartilharemos
i need a nap	preciso de um cochilo
youre mine	você é minha
im eating	estou a comer
we liked tom	nós gostamos do tom
dont respond	não respondam
let me see	deixemme ver
no one cared	ninguém ligou
i made it up	eu inventei
are we alone	estamos sozinhos
i hear you	estou te ouvindo
this is ok	está ok
tom has it	tom tem
take command	assuma o comando
be quiet now	fique quieto agora
i remember	lembro
he can swim	ele consegue nadar
can i try it	posso tentar
im a purist	sou um purista
check that	verifiquem isso
i phoned him	eu liguei para ele
im useless	eu sou inútil
i drink wine	eu bebo vinho
im selfish	eu sou egoísta
i sell shoes	eu vendo sapatos
it may rain	pode ser que chova
he is tall	ele é alto
they lied	eles mentiram
how exciting	que massa
who fell	quem caiu
she is dead	ela está morta
how clever	que esperto
take it easy	pegue leve
wake up	acorda
be calm	fique calmo
i can run	eu sei correr
was it cold	estava frio
come on	venha
is that me	esse sou eu
youre small	você é pequeno
take it	pegaa
can tom sing	o tom sabe cantar
lets go	vamos
i want it	eu quero isso
answer me	me responda
my eyes hurt	meus olhos estão doendo
dont be rude	não seja grosseiro
i am a muslim	sou muçulmana
im too busy	estou muito ocupado
dont kid me	não brinque comigo
youre old	vós sois velhos
trust in me	confie em mim
im an actor	sou ator
keep focused	mantenhase focado
thats my cd	é o meu cd
its unusual	é incomum
i will wait	vou esperar
dont go	não vá
its not tom	não é o tom
im old	eu sou velha
mary is mine	a mary é minha
get some rest	descansa um pouco
get out	sai
he tries	ele tenta
have a look	dê uma olhada
leave me	me deixe
tom tried	o tom tentou
get lost	se manda
how strange	que estranho
were hot	nós estamos com calor
i can sing	eu sei cantar
well try	nós vamos tentar
i was awake	eu estava acordado
good night	boa noite
i found it	eu encontrei
get away	fora
god bless you	deus vos abençoe
get down	escreva
i forgot	me esqueci
i prayed	eu rezei
ive done it	eu fiz
i didnt ask	eu não perguntei
i am hungry	tenho fome
im safe now	eu estou seguro agora
i love mary	eu amo maria
were buying	nós estamos comprando
youre sad	vocês estão tristes
sign here	assine aqui
he is old	ele é velho
wash up	lavese
i miss you	estou com saudades de você
its snowing	está nevando
its true	é verdade
are you there	tu estás aí
we need tom	nós precisamos do tom
i like cats	eu gosto de gatos
its clear	é claro
is this mine	essa é a minha
i loved you	amavaa
what a pity	que lástima
youre sick	você é doente
im married	eu sou casado
im not you	não sou você
have a look	dá uma olhadela
i smiled	eu sorri
i surrender	eu me rendo
this is his	isto é dele
tom is a vet	tom é um veterano
i found it	achei
is it a wolf	é um lobo
who swam	quem nadou
i shouted	eu gritei
help me out	ajudeme
theyre kids	eles são crianças
who has it	quem tem
come inside	entra
you won	vocês venceram
ill pay you	eu irei te pagar
sign here	assina aqui
tom whistled	tom assobiou
tom is deaf	tom é surdo
dont move	não se mova
thats all	isso é tudo
bring backup	traga reforço
its so dark	está tão escuro
i wont die	eu não vou morrer
im fine	eu vou bem
dont laugh	não riam
tom is gone	tom se foi
well wait	nós esperaremos
im clumsy	sou desajeitado
tom was hit	tom foi atingido
he loves toys	ele adora brinquedos
tom is alive	tom está vivo
what fun	que divertido
she is eight	ela tem oito anos
anyone hurt	alguém machucado
there it is	aqui está
lighten up	relaxe
what a shock	que choque
get up	levantemse
of course	claro que sim
grab tom	pegue o tom
they love me	eles me amam
were weak	nós somos fracos
be careful	tenha cuidado
im not poor	não estou pobre
be punctual	sejam pontuais
toms early	tom está adiantado
dont cheat	não colem
dont fight	não lutem
i fixed it	eu a consertei
im fine	estou bem
i like that	gosto
hurry up	se apressa
catch tom	pegue o tom
i want one	quero um
youre crazy	você é doido
tom nodded	tom acenou
stop it	pare
we can pay	nós podemos pagar
im a doctor	eu sou médico
im horrible	estou horrível
come in	entra
i like it	eu gosto dele
ill get in	vou entrar
now go home	agora vá para casa
he is no fool	ele não está louco
who will pay	quem vai pagar
he avoids me	ele evitame
how beautiful	que bonita
is tom good	tom é bom
shut it off	desliguea
tom told him	tom disse a ele
are you lost	vocês estão perdidos
were mature	nós estamos maduros
im an adult	eu sou adulta
im neutral	eu sou neutro
toms thirty	o tom tem trinta anos
i love them	eu as amo
come at once	venha aqui imediatamente
i wont go	eu não irei
did it work	funcionou
i like girls	eu gosto de meninas
open fire	abrir fogo
it was empty	estava vazio
im healthy	estou com a saúde em dia
im through	terminei
i give up	eu desisto
toms coming	tom virá
tom arrived	tom chegou
here i come	aqui vou eu
i believe you	acredito em você
they fell	elas sentiram
i have needs	eu tenho necessidades
is it time	está na hora
be tolerant	seja tolerante
check again	verifique de novo
i am tired	eu estou cansada
i like him	eu gosto dele
i grunted	eu resmunguei
listen	escutai
well decide	nós decidiremos
i feel safe	eu me sinto em segurança
terrific	fantástico
back off	para trás
its sweet	isso é doce
come at once	venha logo de uma vez
he got away	ele se afastou
he runs	ele corre
i feel cold	tenho frio
it snowed	nevou
get moving	mexase
he is lazy	ele é preguiçoso
dont do that	não faça isso
stay calm	fique calmo
stop moving	parem de se mexer
take a bus	pegue um ônibus
youve grown	vocês cresceram
well do it	nós o faremos
put it there	coloqueo ali
how awful	que horror
we need more	precisamos de mais
we need time	nós precisamos de tempo
did i ask you	eu te pedi
dont go in	não entrem
answer me	me responde
ignore that	ignore isso
forget it	esqueça
stop that	pare com isso
now im sad	agora estou triste
he looks well	ele parece bem
i hate golf	eu odeio golfe
im starved	estou morto de fome
thats life	é a vida
tom stopped	o tom parou
is it windy	está ventando
a car hit tom	um carro bateu em tom
tom is timid	tom é tímido
go ahead	vá em frente
i know him	eu conheçoo
close the box	feche a caixa
i believe tom	acredito no tom
i sneezed	eu espirrei
that will do	isso bastará
im ok	estou bem
i do like tom	faço como o tom
i wont bite	não vou morder
warn tom	avisem ao tom
take care	tome cuidado
its a rumor	é boato
hands off	tire as mãos
get out	sai
im upset	eu estou chateado
were ok	estamos bem
no way	de modo algum
listen	escuta
keep walking	continue caminhando
i want mine	eu quero a minha
its wrong	está errado
bring food	traga comida
it was mine	era meu
i was fired	despediramme
tomll cry	tom vai chorar
they tried	eles tentaram
too late	tarde demais
tom cheats	tom trapaceia
birds sing	os pássaros cantam
toms pushy	tom é insistente
tom is lucky	tom é sortudo
no objection	sem objeções
am i fired	estou demitido
we talked	conversamos
we must act	nós precisamos agir
its too far	está longe demais
he went blind	ficou cego
im fasting	estou jejuando
im lucky	eu sou sortudo
its mine	é meu
i am a woman	sou mulher
dont try me	não me tente
im not home	não estou em casa
i agree	estou de acordo
tom is slow	tom é lento
he dug a hole	ele cavou um buraco
are they here	eles estão aqui
were joking	estamos brincando
try this	experimenta isto
tom answered	tom respondeu
youre timid	tu és tímido
tom isnt ok	tom não está bem
lets play	joguemos
help tom	ajudem o tom
i have a car	tenho um carro
i forgot	esqueci
im no fool	não sou idiota
tom stopped	tom parou
tom frowned	tom franziu a testa
youre nuts	está maluco
leave now	saia agora
im not ok	eu não estou bem
dont push me	não me empurre
goodbye	até mais ver
i will learn	irei aprender
im awake	estou acordado
im bald	eu sou careca
wait here	esperem aqui
hey relax	ei relaxe
ill ask tom	perguntarei ao tom
well fight	nós vamos lutar
its for you	é para você
i got stuck	eu fiquei preso
i want these	eu quero aqueles
ill live	eu vou viver
im not tom	eu não sou o tom
stay down	fiquem abaixados
i love tom	eu amo tom
im a farmer	sou um agricultor
i said no	eu disse que não
can i use it	posso usar isso
he is too old	ele é muito velho
im busy now	estou ocupado agora
i feel alive	sintome vivo
take care	toma cuidado
tom is nasty	o tom é repugnante
look at us	olhe para nós
dont panic	não entre em pânico
stop gawking	não fique aí babando
toms early	o tom está adiantado
look alive	ande
do your best	dê o melhor de si
tom snores	tom ronca
they agree	elas concordam
tom saw it	o tom o viu
dont argue	não discutas
of course	é claro
tom cringed	tom se encolheu
who is he	quem é ele
wholl start	quem vai começar
follow tom	siga o tom
i love you	eu vos amo
come out here	venha aqui
i found it	eu a encontrei
its perfect	está perfeito
hey its me	ei sou eu
i want that	quero aquilo
youre nuts	estás louco
they smiled	eles sorriram
run	corre
it may snow	pode nevar
hang on	aguarde
i need money	preciso de dinheiro
let me see	deixeme ver
who was here	quem estava aqui
were young	somos jovens
come quickly	venham rápido
shes stupid	ela é burra
i need you	preciso de você
tom ate	tom comeu
im blind	sou cega
step back	para trás
keep trying	continue tentando
is tom ill	o tom está doente
i got bored	eu fiquei entediada
i cant fly	eu não posso voar
i cant stop	não posso parar
tom is ugly	tom é feio
is it for me	isso é pra mim
he dozed off	ele adormeceu
tom did that	tom fez aquilo
wake up tom	acorde tom
calm down	acalmate
stay here	fiquem aqui
go home	vão para casa
do it anyway	faça de qualquer forma
im very fat	sou muito gordo
i trust you	confio em você
keep smiling	continue sorrindo
i hope not	espero que não
are you alone	você está só
look out	preste atenção
i survived	eu sobrevivi
get back here	volte aqui
we like tom	gostamos do tom
im nervous	estou nervoso
how annoying	que chato
seriously	é mesmo
ill try it	eu vou experimentar
you know her	vocês a conhecem
lifes short	a vida é curta
stop moving	pare de se mexer
let me die	deixeme morrer
im obese	estou obeso
we all quit	fomos todos embora
i understand	compreendo
i could help	eu pude ajudar
is it a joke	é uma piada
whats new	que novidade há
may i go	posso ir
are they busy	eles são ocupados
i need it	preciso disso
im fair	eu sou justo
tom is tired	tom está cansado
start over	recomece
come alone	venha sozinha
tell tom	conta para o tom
its a curse	isso é uma maldição
how is it	como é isso
we went out	nós saímos
tom wake up	tom acorda
you scare me	você me dá medo
check this	verifica isto
its a fish	isto é um peixe
stay a while	fique um pouco
stand still	fique parado
im free	estou livre
he has a car	ele possui um carro
vote for me	vote a meu favor
ive no idea	não faço ideia
that does it	tom faz
i missed it	perdi isso
its a trick	é um truque
be prepared	esteja preparado
i was cold	eu estava com frio
i will fight	eu vou lutar
dont be shy	não seja tímida
is it dirty	está sujo
tom hates me	tom me odeia
i want you	eu o quero
were twins	somos gêmeos
ignore him	ignore ele
they cheat	eles trapacearam
let go of me	solteme
im certain	estou seguro
wait a while	espere um momento
stop that	parem com isso
he is eating	ele está a comer
i ate out	eu comi fora
call home	ligue para casa
you can go	você pode ir
it is my cat	este é o meu gato
he lost face	ele perdeu prestígio
ask them	pergunte para elas
its clear	está claro
its	são
tom dozed	tom cochilou
point it out	indique
they agree	concordam
i called tom	eu liguei para o tom
ill be back	eu já volto
they lost	eles perderam
i love cats	amo gatos
i forgot it	eu me esqueci disso
can tom swim	tom sabe nadar
i cant sleep	eu não posso dormir
were crazy	somos malucas
whos paying	quem vai pagar
i always lose	eu sempre perco
stop tom	interrompam o tom
grab him	agarreo
i drive fast	eu dirijo rápido
go	vai
fix this	conserta isto
he loved her	ele a amava
love hurts	o amor machuca
be creative	sejam criativos
have another	toma outro
who wrote it	quem escreveu isso
we failed	falhamos
i use this	eu uso isso
im so fat	eu sou muito gordo
who phoned	quem chamou
im not poor	não sou pobre
are they here	elas estão aqui
how deep	quão fundo
are they busy	eles estão ocupados
will you go	você vai
i phoned	eu telefonei
no problem	sem problema
i resigned	eu renunciei
tom ate it	tom o comeu
im loyal	eu sou leal
got it	entendeu
take it easy	pega leve
it was wet	estava molhada
then what	e então
hands off	tirem as mãos
i dont cook	eu não cozinho
its funny	isso é engraçado
i found it	eu achei
tom finished	o tom terminou
theyve gone	elas se foram
we must try	devemos tentar
i often ski	eu esquio com frequência
whats that	o que é aquilo
are you nuts	você é louco
toms funny	tom é engraçado
i can jump	eu posso pular
thanks	obrigada
i feel old	sintome velha
see above	vejam acima
ill do this	vou fazer isso
im guilty	eu sou culpado
id do it	eu faria isso
i live here	moro aqui
we have food	temos comida
be kind	sejam gentis
im a father	sou pai
i am here	estou aqui
help me	me ajude
im staying	eu fico
youre old	as senhoras estão velhas
we lost	nós perdemos
no one cared	ninguém se importou
is it dirty	isso está sujo
were awake	estamos acordados
be realistic	seja realista
i like cats	eu adoro gatos
youre cute	tu és bonito
are we safe	estamos seguros
i do hope so	eu realmente espero
i have a pen	tenho uma caneta
he ran	ele corria
tom is mad	tom está louco
am i mistaken	estou errado
im dyslexic	sou disléxico
its hot	está quente
catch tom	peguem o tom
you are mad	você é louco
help tom out	ajude o tom
im safe now	estou seguro agora
im shocked	eu estou chocado
plants grow	as plantas crescem
look around	dá uma olhada em volta
see you	até mais
wait	espere
im nervous	eu estou nervoso
bring wine	tragam vinho
i was alone	eu estava sozinho
thats fine	está bem
come quickly	venha rápido
god bless you	deus te abençoe
why not both	por que não ambas
youre upset	tu estás chateado
youre old	és velha
are you lost	você está perdido
im naked	estou pelado
are you there	está aí
who is it	quem é
hes too old	ele é muito velho
im autistic	eu sou autista
were dying	estamos morrendo
we can begin	podemos começar
ive eaten	eu comi
i dont study	eu não estudo
im not here	eu não estou aqui
im so tired	estou tão cansado
life is fun	a vida é divertida
get started	comecem
look at that	olhem para aquilo
i miss you	sinto a tua falta
its amazing	isso é incrível
listen	escutemme
im addicted	estou viciado
im naive	eu sou ingênua
tom moaned	tom gemeu
i screamed	gritei
thats trash	é lixo
were fine	estamos bem
take a rest	descanse
this is free	é gratuito
thanks a lot	muito obrigado
be serious	fiquem sérias
whos that	quem é
its ours	é nosso
i will stay	eu vou ficar
toms happy	tom é feliz
im clumsy	sou desastrado
i hate you	eu te detesto
its monday	é segunda
i noticed	notei
im shy	eu sou tímido
who is there	quem está aí
tom is early	tom está adiantado
tom went out	tom saiu
tom looked	tom olhou
back off	recuem
i love rock	eu adoro rock
i hope not	eu espero que não
i am tall	eu sou alto
go away	afastese
i saw that	eu o vi
are you mad	você está com raiva
mary giggled	mary riuse à socapa
tomll come	tom vai vir
youre crazy	você é louco
im so fat	estou tão gordo
fantastic	fantástico
thats fun	isso é divertido
be tolerant	sede tolerantes
he was busy	ele estava ocupado
come off it	esqueça
got it	entendi
forget it	esqueça
thats trash	isso é lixo
where are we	onde nós estamos
be kind	sê gentil
try some	experimente
im a hero	sou herói
tom is crazy	o tom é louco
im relaxed	estou relaxada
who stood	quem estava de pé
i will shoot	irei atirar
toms afraid	tom está com medo
show me	mostreme
pick a card	escolha uma carta
were fair	nós somos justos
examine them	examineos
im winning	estou ganhando
ill ask tom	eu vou perguntar para o tom
tom spoke	tom falou
how awful	que ridículo
you used me	você me usou
am i fat	estou gordo
seriously	sério
i think so	acredito que sim
can i hug you	eu posso te abraçar
calm down	acalmese
am i dying	eu estou morrendo
anything new	alguma novidade
well try	nós tentaremos
i missed you	senti sua falta
he has a blog	ele tem um blog
after you	você primeiro
we forgot	nós esquecemos
wholl cook	quem vai cozinhar
were adults	nós somos adultos
did tom eat	o tom comeu
you may go	você pode ir
i am happy	estou contente
use this	use isso
ill open it	eu vou abrir
be nice	sejam legais
tom is out	tom está fora
do it with me	faz comigo
get serious	fique sério
bless you	saúde
tom is wrong	o tom está errado
hes not in	ele não está
i like that	gosto disso
did you lose	você perdeu
i miss you	tenho saudades tuas
i am a boy	sou um menino
i doubt it	eu duvido
dont talk	não fale
were dizzy	nós estamos tontos
let me out	deixame sair
im old	eu estou velha
it was sad	foi triste
tom drinks	tom bebe
get up	levantate
tom ran	o tom correu
tom knows	tom sabe
tom met mary	tom conheceu mary
we were busy	estávamos ocupados
step inside	dê um passo adentro
we loved tom	amávamos o tomás
be careful	toma cuidado
i hope so	espero que sim
is it true	é verdade
i am better	estou melhor
help	socorro
wait	esperem
i still care	eu ainda me importo
i like blue	eu gosto de azul
dont fight	não lutes
that was odd	isso foi estranho
take a seat	sentese
is it clean	está limpo
wow	nossa
come quickly	venha depressa
i live here	eu vivo aqui
well done	bem feito
help tom	ajude o tom
you may stay	vocês podem ficar
forget tom	esqueça o tom
i was stupid	eu fui estúpido
be careful	cuidado
listen	ouçame
i ate quickly	eu comi rápido
i like math	eu gosto de matemática
its	são
im loved	eu sou amada
he spoke	ele falou
its stuck	está emperrada
i think so	acho que sim
i cried a lot	eu chorei muito
im full	estou cheia
i didnt sing	eu não cantei
i enjoy that	eu gosto disso
im a pilot	sou piloto
i wont come	eu não irei
he is no fool	ele não é bobo
i want it	quero
no comment	sem comentários
may i eat	posso comer
stop singing	pare de cantar
youre funny	você é engraçado
theyre weak	eles são fracos
are you cops	vocês são policiais
drive on	dirija
we overslept	dormimos demais
he hung up	ele desligou
i keep a dog	eu crio um cachorro
how curious	que curioso
i need a hug	eu preciso de um abraço
were early	estamos adiantados
i forgot it	esqueci
its urgent	é urgente
they approve	eles aprovam
help us tom	ajudenos tom
its my bus	é o meu ônibus
hi im tom	oi sou o tom
were sad	nós estamos tristes
im so happy	eu sou tão feliz
i am curious	eu sou curiosa
let go of me	solteme
im in pain	estou com dor
we are free	estamos livres
get out	saiam
i am thirsty	tenho sede
it isnt tom	não é o tom
tom tries	o tom tenta
trust no one	não confie em ninguém
what is that	o que é aquilo
come with me	venha comigo
i loved you	amavao
theyll grow	elas crescerão
ask tom	pergunte a tom
how romantic	que romântico
whos she	quem é ela
let me out	deixame sair
its mine	é minha
no problem	problema nenhum
theyve gone	eles se foram
tom is wet	tom está molhado
he went blind	ele ficou cego
dont get up	não se levante
were saved	nós estamos salvos
be brave	seja corajoso
tom likes it	o tom gosta disso
were going	nós estamos indo
its perfect	isto é perfeito
toms bored	tom está entediado
who won	quem ganhou
is it normal	isso é normal
we want tom	nós queremos o tom
tom has ocd	tom tem toc
toms right	tom tem razão
eat and drink	coma e beba
tom wants it	o tom quer
im okay	estou bem
im ugly	estou feia
where is he	onde está ele
toms busy	tom está ocupado
i contributed	eu contribuí
i was dizzy	eu estava tonto
tom is odd	tom é esquisito
i am working	estou trabalhando
its ok	tudo bem
tom screamed	tom gritou
check this	verifiquem isto
is it to go	pra viagem
youre old	estais velhos
im coming	eu estou chegando
you are late	você está atrasado
do as he says	façam como ele diz
we failed	nós falhamos
has tom gone	o tom foi
nobody came	ninguém veio
be yourself	seja você mesmo
how many died	quantas pessoas morreram
do your best	dê o melhor de si
who said it	quem disse isso
here i come	estou chegando
hello girls	oi meninas
do it for tom	faça isso pelo tom
i remember	eu me lembro
what a pity	pena
ignore that	ignore
i was hungry	eu estava com fome
take tom	leve o tom
they want me	eles me querem
were lazy	nós somos preguiçosos
no one knows	ninguém faz ideia
i can do it	posso fazêlo
who yelled	quem gritou
i envy her	eu a invejo
he ran	ele correu
im fine	eu estou bem
oh come on	ah vamos
youre old	vós sois velhas
tom is alone	tom está sozinho
i like fruit	eu gosto de fruta
tom cheered	tom aplaudiu
im like tom	sou como o tom
toms not in	o tom não está dentro
theyre old	eles são velhos
we have room	temos espaço
its perfect	isso está perfeito
dont speak	não fale
attack	ataque
he wants more	ele quer mais
look at that	olhe para isso
now you try	agora tente você
keep quiet	fica quieto
leave town	deixem a cidade
im blind	sou cego
keep driving	continue dirigindo
keep this	fique com isto
were busy	estamos ocupados
im yours	eu sou seu
i know	sei
i work here	eu trabalho aqui
stop whining	pare de choramingar
be discreet	sede discretas
im so glad	estou tão feliz
she died	ela morreu
did we win	ganhamos
i want you	eu te quero
tomll talk	tom falará
i cheated	eu trapaceei
i love cats	eu amo gatos
we were lost	nós estávamos perdidas
she is wrong	ela está errada
tom listens	tom escuta
are you lost	vocês estão perdidas
its too far	é longe demais
im here	estou aqui
go ahead tom	prossiga tom
youre old	vocês estão velhas
i waited	eu esperei
i fainted	desmaiei
come closer	chegue mais perto
i talk a lot	eu falo muito
cut it out	pare com isso
i was drunk	eu estava bêbado
ill go	eu vou
here we are	estamos aqui
thats crazy	que loucura
i miss it	saudades
let me sing	deixeme cantar
be confident	sê confiante
was he tom	aquele era tom
how thrilling	que emocionante
dont come	não venham
am i safe now	estou seguro agora
hes broke	ele está duro
i live here	eu moro aqui
good evening	boa noite
im fat	estou gordo
stop talking	para de falar
i have to go	tenho de ir
youre early	você está adiantado
tom approves	tom aprova
i need money	eu necessito de dinheiro
im cold	estou com frio
you hurt him	você o feriu
back off	recua
toms tired	o tom está cansado
youll lose	você vai perder
they walked	eles caminharam
its at home	está em casa
tom is early	o tom está adiantado
can i ask why	eu posso perguntar o porquê
i apologize	peço perdão
my feet hurt	os meus pés estão doendo
youre cute	você é bonito
im thirty	tenho trinta anos
ill go	eu vou
i like cake	eu gosto de bolo
ill cancel	cancelarei
here or to go	para viagem ou para comer aqui
hes a liar	ele mente
run and hide	corre e escondete
do i know him	conheçoo
we promised	nós prometemos
well decide	decidiremos
who stole it	quem roubou
ill pay you	vou te pagar
dont come	não venha
i love jokes	eu adoro piadas
well decide	nos vamos decidir
you cheated	você trapaceou
i am okay	estou bem
i was wet	eu estava molhado
have some	pega um pouco
i missed you	senti tua falta
money talks	o dinheiro é rei
ask anybody	pergunta a alguém
im not rich	não sou rico
get a move on	avante
who vanished	quem desapareceu
tom will try	tom vai tentar
ignore him	ignora ele
tom is smart	tom é inteligente
i eat bread	como pão
im no liar	não sou mentiroso
hug me	me abrace
were right	nós estamos certos
who cares	quem se importa
i do think so	eu acho que sim
stand up	de pé
beat it	se manda
he loves them	ele as ama
calm down	acalmemse
thats her	é dela
many thanks	muito obrigado
were cold	estamos com frio
be creative	seja criativo
im finicky	eu sou exigente
i am happy	eu sou feliz
have a look	vê
my hip hurts	o meu quadril está doendo
stop arguing	pare de discutir
keep singing	continue cantando
i am a muslim	sou muçulmano
ill ask tom	irei perguntar ao tom
we remember	lembramos
im fasting	eu estou em jejum
we need help	precisamos de ajuda
excuse me	perdão
listen	escutem
its cloudy	está nublado
i am okay	eu estou bem
thats tom	aquele é o tom
its strange	é bizarro
thats a lie	isso é mentira
draw a circle	desenhe um círculo
here i come	eu venho
it will burn	vai queimar
tom obeyed	tom obedeceu
we feel bad	nos sentimos mal
this is ours	isso é nosso
i like that	eu gosto dele
im starving	estou morrendo de fome
who was that	quem era essa
youre scary	você é assustador
i like this	eu gosto disto
he talks well	ele fala bonito
step aside	se afaste
well start	nós iremos começar
who talked	quem falou
i failed	eu fracassei
you missed	você perdeu
i winked	eu pisquei
thats fair	é justo
shes hot	ela é gata
its a vice	é um vício
be creative	sede criativas
dont do it	não o faça
i hate tom	odeio tom
im very sad	eu estou muito triste
that is mine	isso é meu
hands off	tira as mãos
look there	olha ali
were paying	nós estamos pagando
tom saw you	tom te viu
theyre fast	eles são rápidos
he is a poet	ele é poeta
im ready	estou pronto
i feel happy	me sinto feliz
i am studying	eu estou a estudar
i love you	amoo
its red	é vermelha
theyre home	elas estão em casa
he got angry	ele se enraiveceu
i loved you	ameite
ignore that	ignoreo
tom paid	o tom pagou
try it	provea
you cant go	você não pode ir
well help	nós ajudaremos
where was it	onde estava
im doing ok	estou bem
here we are	aqui estamos
im ready	estou pronto
is tom lying	o tom está mentindo
tom stutters	tom gagueja
its our car	é o nosso carro
do it anyway	faça mesmo assim
i helped out	eu ajudei
you will die	você vai morrer
theyll call	eles chamarão
tom ate	o tom comeu
try again	tentem de novo
now im sure	agora estou convicto
im happy	eu sou feliz
toms lonely	o tom está solitário
were calm	estamos tranquilos
help us	ajudemnos
he is tall	ele é grande
tom paid me	tom me pagou
he laughed	ele riu
we want meat	nós queremos carne
stop there	pare ali
thats great	que bom
tom survived	tom sobreviveu
keep cool	mantenha a calma
i feel old	sintome velho
are you mad	estás tola
tom is ok	tom está bem
im loved	eu sou amado
taste this	experimente isto
back off	recue
why not both	por que não as duas
im very sad	estou muito triste
fill it up	encha o tanque
im horrible	eu sou horrível
im stuck	estou presa
i saw a dog	eu vi um cachorro
get serious	fale sério
be fair	sede justos
all is well	tudo está bem
no way	sem chance
remember it	lembre disso
i cant eat	eu não consigo comer
follow us	sigamnos
you tried	você tentou
we sat there	nós nos sentamos ali
try the cake	experimente o bolo
im free now	agora eu sou livre
well do it	nós faremos
we miss you	estamos com saudade de você
i hired tom	eu contratei o tom
he hugged her	ele a abraçou
hold this	segure isto
i cant read	eu não sei ler
run	corram
whos that	quem é aquele
im jealous	sou ciumenta
now im sure	agora eu tenho certeza
are you in	você está dentro
are we done	terminamos
perfect	perfeito
we all die	todos nós morremos
get over here	venha aqui
i felt cold	eu fiquei com frio
it was fun	foi divertido
there it is	aqui está
we miss tom	nós sentimos saudades do tom
i need glue	eu preciso de cola
oh no	ah não
are you awake	você está acordado
i like fish	eu gosto de peixe
toms eating	o tom está comendo
i felt ill	eu me senti mal
how delicious	que delicioso
god bless you	que deus te abençoe
who will win	quem ganhará
please hurry	apressese por favor
he is not in	ele não está dentro
are you	vocês têm anos
i am trying	eu estou tentando
i missed you	senti sua falta
he is reading	ele está lendo
i want that	quero isso
come quickly	venha rápido
ill change	mudarei
click to edit	clique para editar
i am japanese	sou japonesa
you are ugly	tu és feia
i have time	eu tenho tempo
are you blind	você é cega
she bit him	ela o mordeu
im no liar	eu não sou mentiroso
dont sing	não cantem
they swam	elas nadaram
i got scared	fiquei com medo
youre weak	você é fraco
i want this	quero isso
well starve	nós vamos morrer de fome
ladies first	as damas primeiro
lets see	vejamos
once again	outra vez
come over	venha
we agreed	concordamos
i love you	amote
my eyes hurt	meus olhos doem
im hungry	estou com fome
youre nuts	está doido
i am sick	estou doente
money talks	o dinheiro fala mais alto
tom is upset	tom está chateado
did tom die	o tom morreu
turn it off	desligue
am i too late	estou muito atrasado
mary came in	mary entrou
im sure	tenho certeza
tom drives	tom dirige
dont get fat	não engorde
i exercised	eu me exercitei
they called	ligaram
did tom pray	o tom rezou
i love beer	eu adoro cerveja
ignore tom	ignora o tom
stop moving	pare de se mexer
i cant say	não posso dizer
help me	ajudeme
tom hates it	tom odeia
im a pro	sou um profissional
im a writer	eu sou escritor
well done	bem feito
be sensible	tenham bom senso
that does it	tom faz isso
no one cares	ninguém se importa
can i do this	eu consigo fazer isso
ladies first	primeiro as damas
i like these	gosto desses
you may swim	podes nadar
well be ok	vamos ficar bem
youre cute	vocês são bonitos
there he is	lá vem ele
get your own	pegue o seu próprio
youre fired	vocês estão despedidos
he is drunk	ele está embriagado
anyone home	tem alguém em casa
its done	está pronto
we care	nós nos importamos
i play piano	eu toco piano
i despise tom	eu desprezo o tom
no problem	não há problema
were all ok	estamos todos bem
men cry too	homens também choram
im waiting	estou esperando
show him in	façao entrar
he ignored me	ele me ignorou
you may stay	podeis ficar
do they know	elas sabem
tom was sick	tom estava doente
what a shame	que vergonha
were safe	estamos salvos
its stupid	ele é estúpido
im stuck	eu estou preso
they won	elas venceram
tom is deaf	o tom é surdo
replace it	substitua
please come	vem por favor
i loved you	eu te amava
im poor	sou pobre
tom can cook	tom sabe cozinhar
i give in	eu me rendo
are you home	vocês estão em casa
thats okay	está ok
he is hated	ele é odiado
i was right	eu tinha razão
i said yes	eu disse sim
well dance	dançaremos
is that mine	esse é o meu
did you call	você ligou
this is hers	isso é dela
youre bad	você é mau
were timid	nós somos tímidos
im guilty	eu sou culpada
i am curious	quero saber
im not well	eu não estou me sentindo bem
its there	está lá
you will die	você morrerá
im a cook	sou cozinheiro
dont forget	não se esqueça
it was cold	estava frio
its hailing	está chovendo granizo
i always walk	eu sempre caminho
that works	funciona
i feel blue	estou triste
youre old	sois velhos
do they know	eles sabem
ill get it	eu o pegarei
its a waste	é um desperdício
catch him	pegueo
he has guts	ele tem coragem
eat slowly	coma devagar
im up here	estou aqui em cima
i threw up	eu vomitei
speak up	fala mais alto
my legs hurt	as minhas pernas estão doendo
theyre cool	eles são legais
it happened	aconteceu
i am online	estou online
who are you	quem é você
it was funny	foi engraçado
im the last	eu sou o último
i am in paris	eu estou em paris
tom stayed	o tom ficou
have some	pegue um pouco
i dont mind	não me importo
itll be fun	será divertido
tom got lost	tom se perdeu
lets hurry	apressemonos
we heard you	ouvimos vocês
let me see	deixeme olhar
good job	bom trabalho
im sad	eu sou triste
we like tom	nós gostamos do tom
im picky	sou exigente
tom knew	tom sabia
i want cash	quero dinheiro
i hate you	eu te odeio
tom blinked	tom piscou
theyre new	eles são novos
he seems ill	ele parece doente
im free	eu sou livre
war is evil	a guerra é ruim
hi tom	oi tom
come quick	vem logo
speak slower	fale mais devagar
we knew this	sabíamos disto
im broke	estou falido
i am weak	eu estou fraco
we need tom	precisamos do tom
its a shame	é uma vergonha
tom is shy	tom é tímido
can you come	você pode vir
i was square	eu era quadrado
i live alone	eu moro sozinha
im grounded	estou de castigo
im normal	eu sou normal
i like these	eu gosto desses
how is tom	como vai o tom
were crazy	somos malucos
we need them	a gente precisa deles
it was fair	aquilo foi justo
never mind	esquece
sit with me	sentese comigo
tom got away	tom fugiu
well get it	vamos buscálo
stay down	fique abaixado
is that okay	tudo bem
i came alone	eu vim sozinha
come with me	vem comigo
dont die	não morra
i dug a hole	eu cavei um buraco
he is nice	ele é legal
tom is fussy	tom é muito exigente
why not both	por que não os dois
are you okay	tudo bem contigo
i dont know	eu não sei
be fair	sê justa
thank you	obrigado
do as he says	faça como ele diz
take care	cuidese
i am better	eu sou melhor
are you bored	você está entediada
god exists	deus existe
wait	espere
im happy	eu estou feliz
well attack	nós iremos atacar
tom swam	tom nadou
hold the rope	segure a corda
he got away	ele afastouse
lets hurry	devemos nos apressar
keep away	mantenhase afastado
i cant see	não posso ver
turn it on	ligueo
we want it	nós queremos
i was angry	eu estava bravo
get lost	vaite embora
tom is there	tom está lá
we are happy	nós somos felizes
how is it	como isso é
hello	alô
tom can walk	tom sabe andar
i tried	eu tentei
i will learn	eu irei aprender
were afraid	estamos com medo
stop yelling	pare de gritar
were greedy	nós somos gananciosos
weve won	nós vencemos
turn it on	liguea
who will pay	quem pagará
wholl go	quem vai
i often read	eu leio frequentemente
where am i	onde é que estou
tom is young	o tom é jovem
youre old	a senhora está velha
youre old	as senhoras são velhas
i need it	preciso
im bipolar	sou bipolar
is it far	é longe
try to relax	tente relaxar
im wrong	estou errado
youve tried	você tentou
i love her	amoa
i want mary	eu quero a mary
he lost face	ele perdeu a dignidade
have a seat	sentate
i do like tom	eu faço como o tom
help me	ajudeme
tom laughed	tom riu
say please	diga por favor
are you home	estás em casa
forget him	esqueçao
please smile	por favor sorria
keep out	não entre
theyll know	eles saberão
im sorry	desculpe
im relaxed	estou relaxado
im a father	eu sou pai
tom is awake	o tom está acordado
let me leave	deixame sair
we survived	nós sobrevivemos
its empty	está vazio
i like both	eu gosto dos dois
they hugged	elas se abraçaram
tom is blind	o tom é cego
keep warm	mantenha aquecido
take it	pegao
here we are	aqui estamos
i need a nap	eu preciso de um cochilo
my eyes hurt	os meus olhos estão doendo
tom is pale	tom está pálido
i am a woman	eu sou uma mulher
i love him	eu gosto dele
its a date	é um encontro
whats new	quais as novas
tomll wait	tom vai esperar
really	é sério
this is new	isso está novo
its an omen	é um presságio
he can read	ele consegue ler
tell me	dizme
are we lost	nós estamos perdidos
thatll help	isso vai ajudar
its sad	é triste
he is eight	ele tem oito anos
we survived	sobrevivemos
please leave	abandone o recinto por favor
im not sure	eu não tenho certeza
try again	tente mais uma vez
i am coming	estou chegando
were smart	nós somos espertos
i forgot	eu me esqueci
we just met	acabamos de nos conhecer
be friendly	sejam amigáveis
we try	tentamos
i pay taxes	pago os impostos
get started	começa
youre good	você é bom
im worried	estou preocupada
be serious	fique sério
terrific	magnífico
youll do it	você vai fazer isso
im a genius	eu sou um gênio
hes skinny	ele é magro
theyre fast	elas são rápidas
i love you	amo você
they obeyed	eles obedeceram
please wait	por favor espere
we can swim	sabemos nadar
keep out	afastese
i hate math	eu detesto matemática
look again	olhe novamente
he cheated me	ele me enganou
well get it	nós vamos buscálo
i am curious	eu sou curioso
tom has it	o tom tem
well scream	nós gritaremos
i believe you	eu acredito em vocês
is it toms	é do tom
you are ugly	vocês são feias
i am eating	estou a comer
sign this	assine isso
get out	saia
im young	sou jovem
i am studying	estou estudando
im packing	estou fazendo as malas
ill be late	vou me atrasar
tom grimaced	tom fez uma careta
forgive me	perdoeme
i am going	voume embora
youre old	vocês são velhas
is she nice	ela é agradável
they crashed	eles colidiram
tom was old	tom era idoso
he will walk	ele vai caminhar
im eating	estou comendo
tell me more	fale mais
tom exhaled	tom exalou
i ate caviar	eu comi caviar
tom phoned	tom telefonou
stand by	aguarde
i am a cook	sou cozinheiro
its a pity	é uma pena
dont shout	não grites
will tom die	o tom vai morrer
stay alert	se mantenha alerta
he is kind	ele é generoso
we cant go	nós não podemos ir
get tom	pegue tom
i cant do it	não posso fazer isso
i set a trap	coloquei uma armadilha
anybody here	tem alguém aqui
i felt bad	eu me senti mal
i wont cry	eu não vou chorar
im so bored	eu estou muito entediado
we like it	gostamos disso
hes adorable	ele é adorável
taste this	experimenta isto
love lasts	o amor dura
i do remember	eu me lembro sim
i fell	eu caí
thats it	é isso
be discreet	sejam discretas
i hired tom	contratei o tom
im so happy	eu sou muito feliz
youre shy	você é tímido
jump	pulem
everyone wins	todo mundo ganha
thats ok	está tudo ok
ive lost it	eu o perdi
move over	chegue para frente
tom is bald	o tom é careca
im sociable	eu sou sociável
whos right	quem está certo
be careful	tome cuidado
welcome	bemvinda
were better	estamos melhor
im homesick	estou com saudade de casa
i cant talk	não posso falar
thats odd	é bizarro
dont run	não corras
im not dumb	eu não sou burro
she walks	ela anda
stand still	fique parada
tomll die	tom vai morrer
im not cool	eu não sou legal
youre good	você é boa
aint he cute	ele não é fofinho
i dont mind	eu não me importo
pick him up	pegueo
is it broken	tá quebrado
youll be ok	você ficará bem
tom was ok	tom estava bem
tom said yes	o tom disse sim
beer is beer	cerveja é cerveja
who survived	quem sobreviveu
are you	você tem
i dont care	eu não me importo
i admire you	eu te admiro
run	corre
im faster	eu sou mais rápido
we can do it	nós podemos fazer isso
take the bus	vá de ônibus
we have time	temos tempo
im not deaf	não sou surdo
im at work	estou no trabalho
help him	ajudeo
i will learn	aprenderei
i danced	eu dancei
i know that	eu sei disso
youll do it	você vai fazer
i rarely cry	eu raramente choro
wonderful	maravilhoso
i want mary	quero a mary
i do like you	eu gosto muito de você
lets start	vamos começar
be friendly	sê amigável
he lied to us	ele mentiu para nós
then what	e daí
you go first	por nada
youre gross	você é nojento
im athletic	sou atlético
i dont smoke	eu não fumo
i can fly	eu sei voar
come with us	venham conosco
you know her	você a conhece
im autistic	sou autista
i am happy	estou feliz
tom wake up	tom acorde
i made rice	eu fiz arroz
are you hurt	vocês se machucaram
am i in love	estou amando
you missed	vocês perderam
whos tom	quem é o tom
ill go in	vou entrar
life is hard	a vida é dura
help tom out	ajuda o tom
i wont lie	eu não vou mentir
i want mine	quero o meu
do you smoke	vocês fumam
is that mine	isso é meu
that helped	isso ajudou
im creative	sou criativo
theres tom	ali está o tom
tom drove	tom dirigiu
tom fainted	tom desmaiou
i read lips	leio lábios
they sweated	eles suaram
hows tom	como está o tom
be brave	seja valente
it suits me	ficame bem
dont be rash	não seja precipitado
this is me	este sou eu
i saw a ufo	eu vi um óvni
are you tall	você é alto
sit tight	aguenta firme
im coming	estou chegando
i cant stay	eu não posso ficar
hes asleep	ele está dormindo
hurry home	corra para casa
wait outside	espera lá fora
come along	venha conosco
youre upset	você está chateado
i like tea	eu gosto de chá
i do like you	gosto de você de verdade
im so happy	estou tão feliz
how awful	que terrível
tom is rich	tom está rico
tom works	tom trabalha
bring food	tragam comida
i remember	me lembro
how did it go	como foi
its awkward	é constrangedor
where is it	cadê
are you tired	você está cansado
i am married	eu sou casado
i am weak	eu sou fraco
toms happy	tom está feliz
were here	estamos aqui
its so big	é tão grande
that does it	o tom faz
im next	sou o próximo
he shaved	ele se barbeou
he will walk	ele irá caminhar
i cant cook	eu não sei cozinhar
do you dance	quer dançar
leave tom	deixe o tom
tom is hurt	tom está machucado
try to sleep	tente dormir
no one died	ninguém morreu
its my cd	é o meu cd
what a shame	que pena
try hard	esforcese
my arm hurts	o meu braço está doendo
its too hot	está muito quente
am i right	tenho razão
i also went	eu fui também
cool down	se acalme
who cares	quem liga
i see a rose	vejo uma rosa
keep back	fique afastado
is that you	é você
get your coat	pegue o seu casaco
come and see	venha ver
it cant be	não é possível
take it away	tire isso
dont cry	não chore
clean that up	limpe isso
i regret it	eu me arrependo
youre timid	você é tímida
are you busy	estás ocupada
stop crying	parem de chorar
nobody knows	ninguém sabe
i miss tom	eu sinto saudades do tom
i am thai	eu sou tailandês
you are big	você é grande
youre nuts	estás louco
what a feast	que banquete
well share	a gente vai compartilhar
wait a bit	espera um minuto
ignore tom	ignore o tom
i was joking	eu estava brincando
i remember	eu me recordo
theyre busy	eles estão ocupados
ill read it	eu vou ler
wash up	lavate
theyre gone	eles foram embora
whos dying	quem está morrendo
he is tired	ele está cansado
i lost again	eu perdi de novo
who phoned	quem telefonou
take these	leve esses
youre wise	tu és sábio
youve won	você venceu
tom said yes	tom disse que sim
were twins	nós somos gêmeos
hang on	aguardem
thats right	exatamente
i like pizza	eu gosto de pizza
are you bored	você está entediado
tom is angry	tom está com raiva
what a drag	que chatice
im reliable	eu sou confiável
this is easy	é fácil
move quietly	saia sem fazer ruído
i got stuck	emperrei
youre old	você está velha
dont push	não empurre
terrific	excelente
it was magic	foi mágico
tom was late	tom estava atrasado
stop crying	pare de chorar
this is mine	isso é meu
you scare me	você me assusta
i love trips	amo viagens
wake up	acorde
how do i look	como estou
i like candy	eu gosto de doce
i helped	eu ajudei
get away	se manda
you promised	vocês prometeram
were shy	somos tímidas
keep moving	continue andando
he is lying	ele está mentindo
tom jumped	tom pulou
what is love	que é o amor
im sincere	eu sou sincero
well help	ajudaremos
stop them	detenhamnos
im stunned	eu estou pasmado
what a pity	que pena
well fight	nós lutaremos
im not safe	eu não estou seguro
i will wait	eu irei esperar
get out	fora
go get a beer	vá buscar uma cerveja
be fair	seja justo
forgive us	nos perdoe
tom saw mary	tom viu maria
we love them	nós os amamos
this is real	isso é real
where is it	onde está
show me	me mostre
this is ok	está tudo bem
he is sick	ele está doente
now sit down	agora sentese
keep moving	continue se mexendo
how deep	qual é a profundidade
who is tom	quem é tom
we want tom	queremos o tom
tom got fat	tom engordou
is it ready	está pronto
i cough a lot	eu tusso muito
bring backup	tragam reforços
wait here	espere aqui
its hers	é dela
can you drive	você sabe dirigir
i got scared	eu fiquei com medo
dont run	não corram
tom is thin	tom é magro
we were sick	nós estávamos doentes
im serious	eu estou falando sério
im wrong	estou errada
dont die	não morram
i wont bite	eu não vou morder
youre old	o senhor está velho
please sit	por favor sentese
be cool	seja legal
im coming	eu estou vindo
dont forget	não esqueça
is it safe	é seguro
whos first	quem é o primeiro
i went there	eu fui lá
hi guys	olá pessoal
what a loser	que perdedora
toms famous	tom é famoso
he is spanish	ele é espanhol
he tries hard	ele se esforça muito
all is quiet	tudo está quieto
i miss it	saudades disso
stop smoking	parem de fumar
talk slower	fale mais devagar
he laughed	ele estava rindo
dance with me	dança comigo
who stopped	quem parou
i do love you	eu te amo mesmo
i slept fine	eu dormi bem
cuff him	algemeo
it happens	acontece
you won	você ganhou
i paid tom	eu paguei tom
im a client	eu sou cliente
im a man	sou um homem
we are free	somos livres
whos first	quem é a primeira
please hurry	apressemse por favor
i found it	achei
count to ten	conte até dez
itll work	vai funcionar
tom finished	tom terminou
keep them	fique com eles
we heard you	ouvimos você
im glad	estou contente
you woke me	você me acordou
check this	verifique isto
i teach here	eu dou aulas aqui
it amazed me	surpreendeume
im so fat	sou muito gordo
you did it	você o fez
i eat bread	eu como pão
tell me	digamme
its too far	isso é longe demais
thats him	é ele
call security	chame a segurança
have fun	divirtase
you may stay	vós podeis ficar
i will learn	eu vou aprender
is tom tall	o tom é alto
talk to us	converse com a gente
tom forgot	tom esqueceu
i love him	amoo
hello	oi
i want one	quero um
get real	acorda
are you deaf	você é surdo
wash up	lave o rosto
dont lie	não minta
tom took off	o tom foi embora
ill walk	andarei
ill start	começarei
thats ok	está tudo bem
tom isnt in	tom não está dentro
we all do it	todos nós fazemos isso
tom canceled	tom cancelou
i love it	eu amo isso
youre young	vocês são jovens
carry this	carregue isso
you cheated	vocês trapacearam
i feel silly	eu me sinto idiota
i was wrong	eu me enganei
please relax	por favor acalmese
i found you	eu te encontrei
lets go out	vamos sair
answer me	respondamme
who cheered	quem aplaudiu
youre cute	os senhores são bonitos
be friendly	sede amigáveis
they crashed	elas bateram
its similar	é parecida
lets dance	dancemos
he grows rice	ele cultiva arroz
we want one	nós queremos uma
its late	é tarde
he liked that	ele gostou daquilo
money talks	o dinheiro manda
is it you	é você
you called	você ligou
he talks well	ele fala bem
is that tom	aquele é o tom
its so cute	é tão fofo
i understood	eu entendi
dont be shy	não seja tímido
well dance	nós vamos dançar
i am tall	sou alto
im not mad	eu não sou louco
keep it	fica com ele
tom is nosy	tom é intrometido
youre old	tu estás velha
tell tom	conte ao tom
he smiled	ele sorriu
i jumped	eu pulei
tom is wise	tom é sábio
well attack	iremos atacar
what an idea	que ideia
i hate dogs	odeio cachorros
are you going	vocês estão indo
take this	pegue isso
keep cool	te acalma
i sell shoes	vendo sapatos
go ahead	continue
do you agree	você concorda
were even	estamos quites
get dressed	vistase
tom agrees	tom concorda
stop moving	parem de se mexer
try some	experimenta
we won	vencemos
hi im tom	olá sou o tom
we were lost	nós estávamos perdidos
hows tom	como vai o tom
do it for me	faça isso para mim
i am hot	tenho calor
you run	corra
they know us	eles nos conhecem
we wont win	nós não vamos vencer
i dont sing	eu não canto
all is still	tudo está calmo
i dont bite	eu não mordo
do it with me	faça comigo
hes swiss	ele é suíço
are you lying	você está mentindo
i got sick	eu fiquei doente
take a nap	tire um cochilo
we know tom	nós conhecemos tom
you amuse me	você me diverte
be prepared	estejam preparados
i need a job	preciso de um emprego
i am injured	estou machucado
its sweet	está doce
i regret it	me arrependo
youre smart	você é esperta
i want cash	eu quero dinheiro
im up	estou acordado
lets quit	vamos embora
she woke up	ela acordou
i got it	eu entendi
i need a pen	eu preciso de uma caneta
he coughed	ele tossiu
im not tall	eu não sou alto
you may stay	tu podes ficar
im a poet	sou poeta
please sing	cante por favor
can i ask why	posso perguntar o porquê
do what i say	façam o que eu digo
i did nothing	eu não fiz nada
theyre busy	elas estão ocupadas
its alive	ele está vivo
calm down	te acalma
im stuck	estou preso
im sorry	sinto muito
i want you	querote
it is a book	isso é um livro
will he live	ele vai viver
do i know tom	conheço o tom
youre safe	você está seguro
well be ok	nós vamos ficar bem
jump	pule
are you	vocês têm
were tired	estamos cansados
lift it up	levanteo
its working	está funcionando
i found you	te encontrei
i am japanese	eu sou japonês
stop	pare
keep looking	fique olhando
answer me	respondame
no way	de jeito nenhum
ill drive	dirigirei
come along	venha com a gente
i want you	eu a quero
tom died	o tom morreu
were famous	somos famosos
im young	eu sou jovem
really	sério
its blank	está em branco
please relax	por favor relaxe
im married	eu sou casada
you can come	você pode vir
im not dead	não estou morto
tom shaved	tom fez a barba
you promised	você prometeu
can you see	dá para ver
lets begin	vamos começar
sit here	senta aqui
may i sing	eu posso cantar
sit still	fique parado
theyre in	eles estão dentro
its stuck	está emperrado
can i go too	posso ir também
bring it back	traga de volta
follow him	sigao
im stuffed	estou cheio
do it for me	façam isso para mim
check that	verifica isso
we agree	nós concordamos
well done	parabéns
tom is scary	tom é assustador
tom will cry	tom vai chorar
i love you	eu te amo
tom is drunk	tom está embriagado
i didnt pay	eu não paguei
here we are	eisnos aqui
my leg hurts	minha perna dói
i raised tom	eu criei tom
dont be rude	não seja rude
whats up	tudo em cima
tom is nuts	tom está biruta
tom likes it	tom gosta
dont go away	não se vá
im not bald	eu não sou careca
im well	estou bem
turn it off	desligao
warn tom	fale para o tom
we are late	estamos atrasados
i hear you	eu te ouço
i feel tired	me sinto cansado
who knows	quem sabe
are you crazy	você está louco
youll do it	vocês vão fazer isso
he seems sick	ele parece doente
tomll cry	tom irá chorar
tom knows me	tom me conhece
its true	é verdade
youve won	vocês ganharam
tom is small	tom é pequeno
i want mine	eu quero o meu
she runs	ela corre
i dont lie	eu não minto
its	são
im fast	sou rápido
i went home	eu fui para casa
im the law	eu sou a lei
toms shy	tom é tímido
let go of it	solte isso
im mad	estou bravo
keep talking	continue falando
i was lucky	tive sorte
vote for tom	vote em tom
bring wine	traga vinho
i got up	eu me levantei
tom is naive	tom é ingênuo
i need paint	eu preciso de tinta
run	corra
i will try	vou tentar
i have eyes	eu tenho olhos
i cant swim	eu não sei nadar
im sober	estou sóbrio
tom is calm	tom está calmo
its new	isso é novo
read this	leia isso
this is ok	está bem
just relax	apenas relaxem
hit tom	acerta o tom
he just left	ele acabou de sair
im not sick	eu não estou doente
im stuffed	estou cheia
are you dying	você está morrendo
we agree	concordamos
have faith	tenha fé
i coughed	eu tossi
go away	cai fora
i drink milk	eu tomo leite
i did my best	fiz o melhor que pude
take it	peguea
wash up	lavemse
tom forgot	tom se esqueceu
its a rumor	é um boato
here we are	estamos aqui
i want this	eu quero isso
i dream a lot	eu sonho muito
look back	olhe para trás
hurry up	depressa
he avoids me	ele me evita
they voted	eles votaram
thats a lie	aquilo é mentira
i overslept	dormi mais do que devia
im bleeding	estou sangrando
have a seat	sentemse
come this way	vem por aqui
you fainted	você desmaiou
set tom free	libertem tom
keep focused	mantenha o foco
im trying	estou tentando
youre fools	vocês são burros
have a look	dá uma olhada
feed the bird	alimente o pássaro
you may stay	as senhoras podem ficar
im loved	sou amado
its fun	é divertido
he is a thief	ele é um ladrão
they agree	eles concordam
im bored	estou chateado
they refused	eles recusaram
tomll help	tom ajudará
its bizarre	é bizarro
tomll pay	tom irá pagar
take a bus	peguem um ônibus
please hurry	despachate por favor
help us	ajude a gente
im puzzled	estou intrigado
they walked	elas caminharam
youre old	a senhora é velha
be confident	seja confiante
we miss you	nós estamos com saudade de você
im lost	estou perdido
toms well	o tom está bem
come closer	chega mais perto
i need a hat	preciso de um chapéu
did you swim	você nadou
tom stayed	tom ficou
whos paying	quem está pagando
i am thirsty	estou sedento
i love you	te amo
itll be ok	vai ficar tudo bem
we need them	nós precisamos deles
he felt tired	sentiase cansado
were right	estamos certos
nobody lied	ninguém mentiu
tom yawned	tom bocejou
tom was fast	tom foi rápido
tom is old	o tom está velho
thats crazy	isso é loucura
ill do this	eu o farei
tom saw me	tom me viu
who panicked	quem entrou em pânico
tom is funny	tom é engraçado
i am busy	estou ocupada
it scared me	assustoume
were inside	estamos dentro
im escaping	eu estou escapando
release tom	solte o tom
i love tea	eu adoro chá
let me go	deixeme ir embora
tom is bored	tom está entediado
you are ugly	tu és feio
hello	olá
i noticed	eu notei
did tom win	o tom ganhou
its secret	é segredo
we waited	nós esperamos
i forgot	eu esqueci
tom danced	tom dançou
go ahead	vá em frente
i am human	sou humano
you need me	você precisa de mim
stay there	fique aí
please come	venham por favor
we knew that	sabíamos disso
we remember	nós estamos lembrados
dont scream	não gritem
we are boys	somos meninos
youre ok	você está bem
tom smiled	tom sorriu
i am chinese	sou chinês
she shot him	ela atirou nele
take care	cuidese
i cant win	eu não posso vencer
i need you	preciso de ti
listen up	escutem
were young	nós somos jovens
hes my age	ele tem a minha idade
she may come	pode que ela venha
we buy cds	compramos cds
sing with us	cante conosco
this is fine	está perfeito
im sleepy	estou com sono
youre sick	vocês estão doentes
are you sad	você está triste
im a cook	sou cozinheira
he has a car	ele tem um automóvel
i drank tea	eu tomei chá
thisll help	isso vai ajudar
stand aside	afastese
it failed	falhou
i can read	eu sei ler
youre lost	vocês estão perdidas
im losing	estou perdendo
then what	e agora
im certain	tenho certeza
it wasnt me	não fui eu
come quick	venha rápido
sit down	assentese
eat and drink	come e bebe
it was nice	foi legal
move over	chega para frente
who are you	quem são vocês
could it work	poderia funcionar
theyre in	estão dentro
this was fun	isto foi divertido
i feel cold	estou com frio
im bushed	eu estou exausto
i surrender	me rendo
dont push	não empurres
is tom alone	o tom está sozinho
tom approved	o tom aprovou
im rich	eu sou rica
stop tom	impeça o tom
who saw you	quem te viu
what a loser	que perdedor
i recovered	eu me recuperei
can i eat	posso comer
do i know you	eu conheçoo
wait up	esperem
thats fun	é divertido
keep quiet	fique quieto
go	vá
how cute	que bonitinha
i need it	eu preciso disso
its serious	isto é sério
youre lucky	você é sortuda
really	mesmo
go inside	vá para dentro
tom was kind	tom foi gentil
study hard	estude muito
i love cake	eu adoro bolo
theyre late	eles estão atrasados
i understood	entendi
they want me	elas me querem
im doing ok	eu estou bem
i am sick	sou doente
ill manage	conseguirei
he wants one	ele quer um
keep running	continue correndo
speak up	fale mais alto
im in rome	eu estou em roma
toms sad	tom está triste
its alive	ela está viva
i disagree	discordo
who built it	quem a construiu
who ran	quem correu
describe tom	descreva o tom
check again	confira de novo
you must go	você deve ir
be friendly	seja amigável
are you there	você está aí
i sell cars	eu vendo carros
tom panicked	tom entrou em pânico
well attack	vamos atacar
stand up	levantemse
he got angry	ele ficou com raiva
she hit him	ela bateu nele
i am studying	estou a estudar
how about you	e você como vai
stop smoking	para de fumar
lets leave	vamos embora
we were cold	estávamos com frio
dogs bark	cachorros latem
its free	é gratuito
try this	experimentem isto
its spring	é primavera
stop moving	para de se mexer
tom relaxed	tom relaxou
i wont tell	eu não vou contar
is this real	isso é de verdade
im very fat	sou muito gorda
im okay	eu estou bem
im cooking	estou cozinhando
whos hungry	quem está com fome
tom said no	tom disse não
i love cats	eu adoro gatos
boil one egg	cozinhe um ovo
i need you	eu preciso de você
lets hurry	vamos nos apressar
be fair	sejam justos
you will see	você verá
he shall die	ele deve morrer
i am taller	eu sou mais alto
are you lost	o senhor está perdido
tom is numb	tom é insensível
turn on cnn	ligue na cnn
join us	juntese
tom is heavy	tom está pesado
theyre gone	eles se foram
its food	é comida
he has wine	ele tem vinho
they voted	votaram
blood is red	o sangue é vermelho
are you shy	você é tímido
please leave	saia por favor
well see	veremos
its here	está aqui
let us in	deixenos entrar
ill get up	eu vou me levantar
youre shy	você é tímida
did tom laugh	o tom riu
tom is young	o tom está jovem
ive lost it	perdio
i love you	amo a ti
thats icky	isso é desagradável
see you	nos vemos
he shaved	se barbeou
burn the body	queimem o corpo
she tried	ela tentou
relax	relaxe
keep working	continue trabalhando
i did well	eu fui bem
have a look	veja
shes hot	ela está com calor
im not shy	não sou tímido
wish me luck	desejeme sorte
are you full	você está cheio
come on	vamos
try again	tenta de novo
i will obey	eu vou obedecer
she blushed	ela corou
take a seat	sentese
help me	ajudame
were here	nós estamos aqui
tom was rude	tom foi grosseiro
dont hang up	não desliga
are you tom	você é o tom
dont go in	não entre
well do it	nós faremos isso
youre young	você é jovem
i want tom	quero o tom
bring it back	tragam de volta
i cant surf	eu não sei surfar
im prepared	estou preparada
im drunk	eu estou embriagado
nobody asked	ninguém perguntou
he could die	ele poderia morrer
hello girls	olá garotas
is it here	é aqui
how old is he	quantos anos ele tem
i never win	eu não ganho nunca
he will come	ele virá
i eat a lot	eu como muito
im offended	estou ofendido
thats mine	essa é minha
i am american	eu sou norteamericano
its the law	é a lei
come quick	venha logo
youre shy	vocês estão tímidos
is tom ready	tom está pronto
tom is weak	tom está fraco
i am a boy	eu sou um garoto
time flies	o tempo voa
youre lying	você mente
go inside	vai para dentro
i found it	eu o encontrei
go with tom	vá com o tom
was it good	estava bom
come here	venha aqui
im hurt	estou machucado
i hate beans	eu odeio feijão
fix the clock	conserte o relógio
welcome home	bemvindo a casa
its similar	é parecido
i was afraid	eu estava com medo
tom loves me	tom me ama
toms polite	o tom é educado
im not in	eu não estou dentro
tom is wary	tom está desconfiado
tom grunted	tom grunhiu
im furious	estou furioso
i didnt look	eu não olhei
i will shoot	eu irei atirar
im stuffed	estou cheia
shut up	calemse
youve won	você ganhou
follow me	sigamme
is tom sick	o tom está doente
ive tried	eu tentei
i love you	amoa
im so full	estou tão cheio
hold on a sec	só um segundinho
take command	assuma o controle
they fell	eles sentiram
thats her	é ela
talk to us	fale conosco
i talk fast	eu falo rápido
im better	estou melhor
bring help	tragam ajuda
im pregnant	eu estou grávida
i will shoot	vou atirar
its a fake	é uma imitação
say it again	repita
we need this	nós precisamos disto
i said that	eu disse isso
im ticklish	eu sinto cócegas
feel this	sinta isso
i am divorced	sou divorciado
drive slowly	dirija devagar
i screamed	eu gritei
dont come in	não entre
im all ears	sou todo ouvidos
im untidy	sou desorganizada
be ruthless	seja impiedoso
should we go	nós deveríamos ir
shut it down	desliga isso
please hurry	por favor apressemse
dont stop	não pare
tomll stay	tom vai ficar
he is asleep	ele está dormindo
it saved me	ele me salvou
she knows me	ela me conhece
i want time	quero tempo
im hungry	tenho fome
do what i say	faça o que eu digo
take it easy	tenha calma
please smile	sorria por favor
is it yours	é seu
i am hot	estou com calor
happy easter	feliz páscoa
we loved tom	adorávamos o tomás
i did my part	eu fiz a minha parte
come quickly	venha depressa
youre old	és velho
can he do it	ele consegue fazer isso
what a pity	que pena
whos coming	quem está vindo
mama cried	mamãe chorou
i paid	eu paguei
its my book	esse é meu livro
tell tom	contem ao tom
i fixed it	eu o consertei
keep it	fique com ele
tom blushed	tom morreu de vergonha
ill go in	eu vou entrar
they won	eles ganharam
i burped	eu arrotei
i am hungry	quero comer
were upset	nós estamos chateados
i wont tell	eu não vou dizer
ill lose	vou perder
i am a boy	sou menino
they know me	eles me conhecem
count me in	conte comigo
ill be fine	eu vou ficar bem
its work	é trabalho
she can swim	ela pode nadar
got it	saquei
tom waited	tom esperou
its a doll	é uma boneca
tom was wet	tom estava molhado
we broke up	nós terminamos
im in rome	estou em roma
stay awake	fique acordado
its time	está na hora
ill be here	estarei aqui
they hugged	eles se abraçaram
i bought it	eu comprei
let him in	deixeo entrar
is that a no	isso é um não
i love you	amovos
we like it	gostamos
i cant see	eu não posso ver
im chubby	sou gordinho
can we start	podemos começar
im married	sou casado
im with ntt	eu trabalho na ntt
tom can sing	tom sabe cantar
all is quiet	tudo está calmo
its red	isso é vermelho
toms deaf	o tom é surdo
hes coming	ele está vindo
im on leave	estou de partida
be fair	seja justa
what a drag	que chato
be creative	sê criativo
tom flinched	tom recuou
taste this	experimentem isto
i like you	eu gosto de você
come get some	venha pegar alguns
i want these	quero aquelas
we were cold	nós estávamos com frio
tom had fun	tom se divertiu
what a night	que noite
they stopped	eles pararam
now sit down	agora sente
youre rich	você é rico
im happy	sou feliz
never mind	esqueça
lets chat	vamos conversar
do you fish	você pesca
it matters	importa
isnt it fun	não é divertido
you did this	você fez isso
tom cheated	o tom trapaceou
is tom cured	o tom está curado
i feel happy	sintome feliz
i love math	eu adoro matemática
im famous	estou famoso
get down	abaixese
tom likes it	tom gosta disso
put it on	coloqueo
i want that	eu quero aquilo
who saw me	quem me viu
ill ask tom	eu perguntarei ao tom
i get it	eu entendo
say hello	diga olá
i do my best	eu faço o que posso
dont move	não se mova
ill get in	eu vou entrar
i like music	eu gosto de música
tom likes me	tom gosta de mim
i feel cold	sinto frio
im too fat	eu sou gordo demais
here we are	aqui estamos
i did see him	eu o vi
are you busy	estás ocupado
taste this	prove isto
i hate you	te odeio
i came by car	eu vim de carro
i am lost	estou perdido
thanks again	obrigado novamente
im retired	estou aposentado
dont give up	não desista
they danced	elas dançaram
be serious	fique séria
just do that	apenas faça
can i do this	eu posso fazer isso
take it easy	pega leve
take it	peguemna
im wise	eu sou sábio
were calm	nós somos calmos
im a farmer	eu sou um fazendeiro
tom is hurt	tom está ferido
this is easy	isso é fácil
let me alone	deixame em paz
keep writing	continuem escrevendo
i have	tenho us
whats that	o que que é aquilo
i feel happy	eu me sinto feliz
can he do it	ele pode fazer isso
youll do it	você o fará
she is happy	ela é feliz
come back	voltem
keep quiet	fique quieta
i need water	eu preciso de água
hold it	segure isso
please hurry	por favor apressese
stop staring	pare de encarar
i like you	eu gosto de vocês
i like dogs	gosto de cachorros
i didnt swim	eu não nadei
are you sure	você está certo disso
welcome home	bemvindo ao lar
can i begin	posso começar
tom prayed	tom rezou
im happy	estou feliz
we want it	queremos
dont shoot	não atire
forget me	esqueçame
who was that	quem era esse
its a tv	isto é uma tv
meat please	carne por favor
i didnt win	eu não ganhei
tom is a pro	tom é profissional
toms coming	tom está vindo
thats free	é de graça
im prudent	eu sou prudente
i can feel it	posso sentilo
im strong	sou forte
im yours	eu sou sua
she came	ela veio
im eating	eu estou comendo
is this mine	isso é meu
im drowning	estou me afogando
lets go	vamos
thats over	acabou
go home now	vai para casa agora
be discreet	seja discreta
heres	aqui estão dólares
hes a dj	ele é dj
lets listen	vamos ouvir
i see a star	vejo uma estrela
it may rain	talvez chova
im not lazy	não sou preguiçoso
i think so	eu acho que sim
im a father	sou um pai
it was cool	foi legal
were sick	nós estamos doentes
be punctual	seja pontual
bring him in	tragao para dentro
go away tom	vá embora tom
im no fool	eu não sou idiota
have a look	dê uma olhadela
theyre mine	são meus
say please	falem por favor
ill check	verificarei
were hungry	nós estamos com fome
youre old	o senhor é velho
are you new	você é novo
i was sleepy	eu estava com sono
thats new	isso é novo
take a look	olha
dont smoke	não fume
i cant see	não consigo ver
youre tired	tu estás cansado
theyll know	eles vão saber
im retired	sou aposentado
try to rest	tente descansar
tom will win	tom vai vencer
i need it	eu preciso
they gave up	elas desistiram
i know now	agora sei
she is young	ela é jovem
i will shoot	eu vou atirar
here i come	estou vindo
im here	eu estou aqui
be sensible	tenha bom senso
whos that	quem é aquela
is that okay	está bem
im sneaky	sou sorrateiro
im bossy	eu sou mandão
i forgot it	eu esqueci
its no good	não é bom
we found one	nós encontramos uma
aint he cute	ele não é bonitinho
is it a trap	é uma armadilha
it cant be	mentira
youre early	você está adiantada
forget it	esquece
show him in	mandeo entrar
im stuffed	estou cheio
it was white	era branco
im fine now	estou bem agora
what a waste	que disperdício
make a wish	faça um desejo
sit still	fique parada
come inside	entre
youre shy	tu és tímido
i cant ski	eu não sei esquiar
im broke	estou duro
we can pay	a gente pode pagar
i feel lost	me sinto perdido
study hard	estudem muito
i trust tom	eu confio em tom
im not dead	eu não estou morto
we had lunch	almoçamos
i cant sleep	não posso dormir
i can win	eu posso ganhar
buy some toys	comprem brinquedos
will he die	ele vai morrer
im an adult	eu sou adulto
how many died	quantos morreram
we have food	temos alimento
no way	de maneira alguma
im naked	estou pelada
youre old	tu estás velho
im curious	eu sou curioso
i mean it	estou falando sério
wait a bit	espere um minuto
i like that	eu gosto
we met today	nós nos encontramos hoje
were upset	estamos chateados
is this true	isso é verdade
i have food	eu tenho comida
come sit down	venha se sentar
we like it	nós gostamos disso
take care	se cuida
keep out	afastese
i use this	eu uso isto
is this it	é isso
tom is drunk	tom está bêbado
it is a book	este é um livro
is it clear	está claro
i got upset	eu fiquei chateado
i will work	vou trabalhar
i see a book	vejo um livro
no one came	ninguém veio
welcome home	bemvindo a casa
dont speak	não fales
have a seat	sentese
they cheered	elas aplaudiram
we succeeded	nós conseguimos
hi im tom	oi eu sou o tom
tom is going	tom está indo
i remember	eu lembro
i wont lie	não vou mentir
im very shy	eu sou muito tímido
well done	bravo
let me sleep	deixeme dormir
do it again	faça de novo
im old	eu estou velho
im homeless	sou desabrigado
i often read	leio frequentemente
i do like you	gosto muito de você
i cant smoke	eu não posso fumar
they hate me	eles me odeiam
im alive	estou viva
what is new	o que há de novo
who died	quem morreu
be nice	seja legal
i love you	eu amo vocês
is that mine	essa é minha
i cried too	eu chorei também
am i wrong	estou errada
youre sad	você está triste
toms greedy	tom é ganancioso
tom cant go	tom não pode ir
i can ski	eu sei esquiar
welcome home	bemvindos à casa
im joking	estou brincando
he is ill	ele está doente
i escaped	eu escapei
im not ugly	eu não sou feio
look around	olhe ao seu redor
am i early	eu cheguei cedo
it is	são sete horas e quarenta e cinco minutos
this is cool	isto é legal
this is nice	é legal
im going	eu vou
were dizzy	estamos tontos
tom rocks	tom arrebenta
am i late	estou atrasado
he can swim	ele pode nadar
i was drunk	eu estava embriagado
be creative	sejam criativas
am i dreaming	estou sonhando
i knew it	eu sabia
youre timid	você é tímido
i saved tom	eu salvei tom
are you awake	você está acordada
call me later	ligue para mim depois
dont be mean	não seja mau
we loved you	nós amávamos você
stand up	levantese
help me	ajudemme
theyre back	elas voltaram
warn tom	avise ao tom
he never lies	ele nunca mente
i drank milk	eu bebia leite
you may stay	os senhores podem ficar
see you	a gente se vê
excuse me	o que você disse
you run	você corre
im so fat	eu sou tão gordo
thats odd	isso é bizarro
he loves them	ele os ama
can i try it	posso provar
be fair	sejam justas
sit here	sentese aqui
no means no	não quer dizer não
dont litter	não jogue lixo
she is happy	ela está feliz
be serious	fica séria
i miss tom	sinto saudades do tom
thanks a lot	muito obrigada
hold it	segura isso
tom is a fan	tom é um fã
ask tom	perguntem ao tom
go away	cai fora daqui
be prepared	estejam preparadas
do me a favor	façame um favor
let me out	deixeme sair
i like sushi	eu gosto de sushi
i saw it	eu o vi
i exercised	me exercitei
are they busy	elas estão ocupadas
youre weak	você está fraco
tom walks	tom caminha
are they tall	eles são altos
where am i	onde estou
come tomorrow	venham amanhã
i love you	amo a vós
ill ask tom	vou perguntar para o tom
keep quiet	fique quieto
theyre mine	eles são meus
i panicked	eu entrei em pânico
watch me	observeme
you look sad	você parece triste
look at that	olhem para isso
have a beer	toma uma cerveja
tom got sick	tom adoeceu
it matters	isso importa
we tried	nós tentamos
shut up	cale a boca
i didnt cry	eu não chorei
me too	eu também
im ugly	estou feio
i see a rose	estou vendo uma rosa
its too far	isso está longe demais
i want soup	quero sopa
you survived	vocês sobreviveram
slow down	devagar
well attack	nós atacaremos
try it	proveo
i feel silly	me sinto idiota
here or to go	pra viagem ou pra comer aqui
what for	para quê
i love pizza	eu amo pizza
its so big	é muito grande
cool down	acalmese
ive seen it	eu vi isso
its ok	tá bom
keep quiet	fica quieta
i stayed	eu fiquei
tom helped	tom ajudou
im a mess	eu sou uma bagunça
were inside	nós estamos dentro
i will obey	eu irei obedecer
youre lying	você está mentindo
that worked	aquilo funcionou
tom is fair	tom é justo
forget it	esquece
they called	elas ligaram
stop trying	pare de tentar
tom coughed	tom tossiu
who stole it	quem a roubou
we love you	nós te amamos
we have wine	temos vinho
im yours	sou sua
tom worked	tom trabalhou
i have one	eu tenho um
im very shy	sou muito tímido
i know them	eu os conheço
do you agree	está de acordo
im small	eu sou pequena
tom moved	tom se mudou
tom ran	tom correu
youre kind	você é simpática
tom is safe	tom está seguro
how was tom	como tom estava
please hurry	por favor apressese
im humble	sou humilde
he needs you	ele precisa de ti
dont shout	não grite
tom noticed	tom notou
is it an elk	é um alce
we want it	queremos isso
i want these	quero aqueles
be discreet	seja discreto
they left	eles saíram
she is wrong	ela está equivocada
tom grunted	tom resmungou
here it is	aqui está
smell this	cheire isto
i liked tom	eu gostei de tom
they saw you	eles viram vocês
now sit down	agora senta
tom has it	tom tem isso
take a look	olhe
im deaf	sou surdo
tom is sexy	tom é sexy
we live here	nós moramos aqui
its my life	é minha vida
i am at home	estou em casa
im hiding	eu estou me escondendo
i cant smoke	não posso fumar
toms smart	tom é inteligente
i am thai	sou tailandês
here you are	aqui está você
go now	vá agora
take action	tome uma atitude
i do not work	eu não trabalho
it has begun	começou
it cant be	não pode ser
welcome back	bemvindo de volta
toms eating	tom está comendo
well do it	faremos
dont be shy	não sejas tímido
his nose bled	o seu nariz sangrava
thats hers	é dela
im with tom	eu estou com tom
i was right	eu estava certo
im speaking	eu estou falando
i saw tom	vi o tom
youre fine	você está bem
whos buying	quem está comprando
i like wine	eu gosto de vinho
go away	afastese
theyre lost	eles estão perdidos
its my ship	é o meu navio
be kind	seja gentil
tom lied	tom mentiu
is tom alive	o tom está vivo
we want one	nós queremos um
no kidding	sério
im leaving	estou indo
theyre fine	eles estão bem
this is free	isso é de graça
im not busy	eu não estou ocupado
be brief	seja breve
i have a pen	eu tenho uma caneta
shut up	calese
come on in	entre
dont get mad	não fique brava
are you mad	estás tolo
she smiled	ela sorria
we are men	somos homens
i hate fish	eu odeio peixe
happy easter	feliz páscoa
be confident	sede confiantes
they are big	eles são grandes
is he tall	ele é alto
i got bored	eu fiquei entediado
i saw them	eu os vi
im fat	eu estou gorda
do your best	faça o melhor possível
i lost hope	eu perdi a esperança
ive changed	eu mudei
i saw one	eu vi uma
i hear that	escuto aquilo
i loved you	ameia
im bored	eu estou entediado
say goodbye	diga adeus
let me help	deixeme ajudar
im healthy	estou saudável
tom was old	tom era velho
calm down	acalmese
youre weak	tu estás fraco
im hungry	estou com fome
fire burns	o fogo queima
i sympathize	eu me simpatizo
youre nuts	está louco
life is good	a vida é boa
tom is heavy	tom é pesado
im not you	eu não sou você
stop it	pare com isso
it rained	estava chovendo
i like you	gosto de vocês
am i right	eu estou certa
keep them	fique com elas
this is real	é real
youre weak	tu és fraco
youre lost	você está perdida
i am ready	estou pronto
i got hungry	eu fiquei com fome
i do want it	eu quero muito
how is tom	como tom está
we try	nós tentamos
i won	ganhei
listen	escuta
are you going	você está indo
think again	pense de novo
help me out	me ajude
he liked that	ele gostou disso
my feet hurt	meus pés doem
im coming	estou vindo
did you sign	você assinou
im trying	eu estou tentando
whos there	quem está lá
come back	volte
can you swim	você sabe nadar
youre right	você está certa
keep it up	continue
tom groaned	tom gemeu
start here	comece aqui
tom fell	tom caiu
i like girls	gosto de garotas
mary giggled	mary ria à socapa
tom is happy	tom é feliz
i was tired	eu estava cansado
tom knows us	tom nos conhece
we need them	a gente precisa delas
tom resigned	tom renunciou
i like beef	eu gosto de carne de boi
are you fat	você é gorda
i scared tom	eu assustei tom
show me	me mostra
tom broke it	o tom quebrou isso
have another	tomem outro
he gave in	ele cedeu
its so big	isso é tão grande
he can swim	ele sabe nadar
tom needs me	tom precisa de mim
it worked	funcionou
its sweet	é doce
wow	wow
i am in paris	estou em paris
we got ready	nos preparamos
you owe me	você me deve
were mature	estamos maduros
toms young	o tom está jovem
he has a maid	ele tem uma empregada
tom is neat	tom é legal
its not us	não somos nós
are you sure	vocês têm certeza
is it good	isso é bom
be discreet	sê discreto
bring help	traga ajuda
tom broke it	tom quebrou isso
i made that	eu fiz aquilo
i am hungry	estou com fome
cool off	acalmese
come in	entrem
get lost	váse embora
now get out	agora caia fora
its yen	custa ienes
i eat meat	eu como carne
who stayed	quem ficou
im timid	eu sou tímido
are you mad	você é louco
we can swim	a gente sabe nadar
dont kiss me	não me beije
how cute	que fofinha
i felt cold	fiquei com frio
youre nuts	você está maluco
im working	eu estou trabalhando
tom knew it	tom sabia
he is my boss	ele é meu patrão
did you vote	você votou
please stop	por favor pare
tomll talk	tom vai falar
i am full	estou cheia
i like tom	eu gosto do tom
no one cares	ninguém está nem aí
i can dance	eu sei dançar
be merciless	seja piedoso
are you nuts	estás louco
we all quit	nós todos saímos
have a look	dê uma vista de olhos
we did it	nós conseguimos
take care	te cuida
were mature	nós somos maduros
i loved you	amavate
it cant be	impossível
im curious	quero saber
its for me	é para mim
is this nice	isto é legal
is it broken	está quebrado
he is a dj	ele é dj
ill ask him	irei perguntálo
i got soaked	eu fiquei ensopado
i quit	eu me demito
well do it	faremos isso
im excited	estou excitado
he has a book	ele tem um livro
i hate them	eu os odeio
is tom safe	o tom está seguro
its close	está perto
goodbye	até mais
stop that	parem com isso
its here	é aqui
i want it	quero isso
why not both	por que não ambos
tom was gone	o tomás foise embora
look back	olha pra trás
is it free	é de graça
well pass	nós passaremos
its easy	é fácil
bring it here	traga aqui
its for you	é para vocês
i try	eu tento
do it gently	faz com gentileza
i need mine	preciso do meu
is that tom	é o tom
tom is late	o tom está atrasado
it was tom	foi o tom
she slipped	ela escorregou
take action	tomem uma atitude
can i come in	posso entrar
they approve	aprovam
dont cry	não chorem
be fair	sede justas
am i fat	estou gorda
dont smoke	não fumem
wholl fight	quem lutará
im wet	estou molhada
i had to run	eu tive de correr
who built it	quem o construiu
be creative	sê criativa
were losers	somos perdedores
youve won	vocês venceram
are you there	vocês estão aí
tom was busy	tom estava ocupado
im not free	eu não sou livre
itd be bad	isso seria ruim
are you going	vocês estão indo embora
is this real	isso é real
im bushed	estou exausto
itll happen	isso vai acontecer
i need money	eu preciso de dinheiro
who made it	quem fez isso
i do want it	quero muito isso
youre cute	vocês são bonitas
you start	você começa
be kind	sede gentis
who ate	quem comeu
ive seen it	eu o vi
take a whiff	dê uma cheirada
she walks	ela caminha
im prudent	sou prudente
am i hungry	estou com fome
i tripped	eu tropecei
watch out	cuidado
im fit	estou em forma
im full	estou cheio
i dont agree	não concordo
turn right	vire à direita
i like dogs	eu gosto de cachorro
this is free	é grátis
what a mess	que bagunça
well dance	nós dançaremos
did you sing	vocês cantaram
be discreet	sejam discretos
im canadian	eu sou canadense
im not deaf	eu não sou surdo
where is she	onde está ela
she loves us	ela nos ama
are you here	você está aqui
how far is it	a que distância está
youve grown	você cresceu
im in here	estou aqui dentro
im athletic	eu sou atlético
im upset	estou chateada
i like jazz	eu gosto de jazz
be a good boy	seja inteligente
are they dead	elas estão mortas
try it on	experimentea
i promise	eu prometo
i am injured	estou machucada
i didnt win	eu não venci
toms alone	tom está sozinho
dont come	não venhas
i believe you	eu acredito em você
smile	sorria
dont shoot	não atirem
i drove	eu dirigi
i improvised	eu improvisei
youre cute	tu és bonita
im not done	ainda não estou pronto
i hate that	odeio isso
im in paris	estou em paris
tom saw them	tom viu elas
they approve	elas aprovam
im lonely	eu me sinto só
i read a lot	leio muito
stay there	fica aí
im creative	eu sou criativo
hes lying	ele está mentindo
tom isnt in	o tom não está dentro
i admit it	eu admito
lets play	vamos brincar
has he come	ele veio
im wet	estou molhado
youre old	estais velhas
im ugly	sou feia
toms upset	o tom está triste
i kissed tom	eu beijei tom
step forward	um passo à frente
whose is it	de quem é
dont go tom	não vá tom
who phoned	quem ligou
dance with me	dance comigo
i love you	eu amo você
i want time	eu quero tempo
he is no fool	ele não é idiota
seriously	mesmo
i love books	eu adoro livros
i talk fast	falo rápido
get upstairs	suba
theyre cool	elas são legais
i cant sleep	eu não consigo dormir
he came	ele veio
i could help	eu poderia ajudar
youre lost	vocês estão perdidos
i love snow	eu adoro neve
i got caught	fui pego
tom is naked	o tom está nu
of course	é claro
i always win	eu sempre ganho
shes happy	ela está feliz
i am a boy	sou um garoto
tom likes it	o tom gosta
try this	experimente isto
let me in	deixeme entrar
it burned	queimou
you hurt him	tu o feriste
we met today	nós nos conhecemos hoje
start again	comecem de novo
stay close	fique perto
dont respond	não responda
im yours	sou seu
is he tom	é ele o tom
tom is bad	tom é mau
tom is blind	tom é cego
tom did this	tom fez isto
get a job	arrume um emprego
im starving	eu estou morrendo de fome
trust in god	confie em deus
i am happy	sou feliz
did tom win	o tom venceu
keep that	fique com isso
this is food	isso é comida
ill wait	esperarei
i overslept	dormi demais
i work	eu estou trabalhando
im so fat	estou tão gorda
hes rich	ele é rico
thisll work	isso vai funcionar
keep dancing	continue dançando
i often ski	esquio com frequência
stop tom	interrompa o tom
dont be shy	não fique com vergonha
im resting	estou descansando
finish this	termine isso
terrific	genial
be specific	seja específico
i envy him	eu o invejo
write to me	escrevame
tom giggled	tom deu uma risadinha
its for you	isso é para vocês
who stole it	quem o roubou
im thin	sou magro
i will come	eu virei
i love dogs	eu amo cães
i work a lot	trabalho muito
i like girls	eu gosto de garotas
im alive	estou vivo
i have a dog	eu tenho um cachorro
theyre safe	eles estão seguros
help me	ajudemme
dont shoot	não atire
tom dances	tom dança
be careful	tome cuidado
i agree	eu concordo
did you swim	vocês nadaram
they saw you	eles viram você
ill be fine	vou ficar bem
dont do it	não faça isso
i need a map	eu preciso de um mapa
we succeeded	nós conseguimos
ignore them	ignoremnos
he lost face	ele perdeu o respeito
are we safe	nós estamos seguros
is that ok	está ok
its perfect	isso é perfeito
how strange	que estranho
im not fat	eu não sou gorda
youll see	você verá
stop	parem
i hate dogs	eu odeio cachorros
follow me	me siga
calm down	acalmese
leave now	vá embora agora
i made two	eu fiz dois
may i begin	posso começar
its fair	é justo
be content	fique contente
im waiting	eu estou esperando
i didnt ask	eu não pedi
is this art	isto é arte
write to tom	escreva para o tom
its perfect	é perfeito
this is new	isso é novo
iron is hard	o ferro é duro
dont leave	não vá embora
tom gloated	tom vangloriouse
youre dying	você está morrendo
do you snore	você ronca
i missed you	senti saudade
who will win	quem vai ganhar
theyre boys	eles são meninos
are you done	terminou
im blind	eu sou cego
im strong	eu sou forte
find tom	encontre o tom
they crashed	eles bateram
look closer	olhem mais de perto
get real	cai na real
that does it	o tom faz isso
get over here	vem pra cá
follow me	me sigam
toms polite	tom é educado
im diabetic	eu sou diabético
help yourself	sirvamse
leave me	deixeme
be confident	sejam confiantes
i did my best	fiz o meu melhor
tom died	tom morreu
he came first	ele chegou primeiro
you know me	você me conhece
cheers	saúde
ill stay	ficarei
keep dancing	continuem dançando
have courage	tenham coragem
do your best	faça o seu melhor
i helped out	ajudei
tom is sick	tom está doente
its old	é velho
tomll go	tom vai
really	é mesmo
well drive	vamos dirigir
i was sad	eu fiquei triste
ill be ok	eu vou ficar bem
we think so	nós achamos que sim
im so happy	estou muito feliz
forget it	esqueçam
i like chess	eu gosto de xadrez
how delicious	que delícia
tom swam	o tom nadou
get real	cai na real
toms wrong	o tom está errado
dont leave	não vá embora
she cried	ela chorava
im diabetic	sou diabético
i came by bus	eu vim de ônibus
i came by bus	vim de ônibus
tom stood	o tom levantou
should i go	devo ir
who cheated	quem trapaceou
do i know tom	eu conheço o tom
ill fix it	irei consertálo
he was crying	ele estava chorando
we can swim	nós sabemos nadar
dont risk it	não se aventure
trust in god	confia em deus
who quit	quem desistiu
dont call me	não ligue para mim
trust me	confie em mim
toms lying	tom está mentindo
we miss you	nós sentimos saudades de você
come on	vamos
tom is lucky	o tom tem sorte
tell me	digame
we cant sue	nós não podemos processar
turn left	vire à esquerda
listen	escute
who canceled	quem cancelou
i was full	eu estava cheio
i already ate	eu já comi
im serious	estou falando sério
its me	sou eu
tom is lying	tom está mentindo
he lied to me	ele mentiu para mim
can i help	posso ajudar
wood floats	a madeira boia
cool off	acalmese
i was asleep	eu estava dormindo
i want money	eu quero dinheiro
i see a star	estou vendo uma estrela
were poor	somos pobres
is it white	é branco
can i stay	eu posso ficar
who are they	quem são eles
dont stare	não encara
here he comes	lá vem ele
is tom happy	tom está feliz
i love fish	eu adoro peixe
could we walk	poderíamos caminhar
im a klutz	sou um desastrado
thats great	que bom
he gave up	ele desistiu
youre smart	você é esperto
i want mine	quero a minha
i love you	eu a amo
well try	tentaremos
its all wet	está tudo molhado
am i invited	eu estou convidado
were angry	nós estamos bravos
i dont bite	não mordo
i didnt vote	eu não votei
im honest	eu sou honesto
im nervous	estou nervosa
forgive us	perdoenos
whos wrong	quem está errado
i loved you	eu te amei
i made two	eu fiz duas
youre nuts	estás doido
well check	nós verificaremos
tom helps us	tom nos ajuda
i do like you	gosto muito de vocês
kiss tom	beije tom
im early	estou adiantado
how old is he	qual é a idade dele
call tom	ligue para o tom
its so dark	é tão escuro
how touching	que tocante
may i sing	posso cantar
were hot	estamos com calor
tom clapped	tom aplaudiu
i cant see	eu não consigo ver
youre lying	você está mentindo
whats that	o que que é isso
help yourself	servete
whos there	quem está aí
i see a rose	vejo a rosa
good morning	bom dia
how beautiful	que bonito
did i do that	eu fiz isso
i got it	entendi
i mean it	eu estou falando sério
who are we	quem nós somos
i dream a lot	eu sonho bastante
im drunk	estou bêbado
dont jump	não pule
hes out now	ele não está aqui agora
is it yours	é teu
he has a car	ele tem um carro
you stink	você fede
tom smokes	tom fuma
tomll call	tom irá ligar
i dont drink	eu não bebo
be creative	seja criativa
hes studying	ele está estudando
tom inhaled	tom inalou
i hate cats	eu odeio gatos
im safe	eu estou seguro
i have a car	eu tenho carro
can you skate	você sabe patinar
i have money	eu tenho dinheiro
i found you	encontrei você
hello girls	oi garotas
guess who won	adivinha quem ganhou
help yourself	sirvase
you are ugly	vocês são feios
i am who i am	sou o que sou
im home	cheguei
call me	me liga
did tom vote	tom votou
this is free	é de graça
im dancing	eu estou dançando
get me a beer	pega uma cerveja para mim
its for tom	é para tom
its a trap	é uma emboscada
its not tom	esse não é o tom
hes stupid	ele é burro
can you come	vocês podem vir
fill this out	preencha isto
wake them up	acordeos
come outside	venha aqui fora
come forward	venha adiante
im rational	eu sou racional
youre lying	você está mentindo
are you	você tem anos
keep going	continue
tom kneeled	tom se ajoelhou
dont move	não se mexa
its a fruit	é uma fruta
he is my type	ele é meu tipo
we survived	nós sobrevivemos
youre rich	você é rica
wait up	espere
well help	nós vamos ajudar
im a woman	eu sou uma mulher
i like blue	gosto de azul
tom chuckled	tom deu uma risada discreta
i fainted	eu desmaiei
come with us	venha conosco
take a look	dê uma olhada
is that all	é tudo
who resigned	quem renunciou
have faith	tenham fé
its missing	está faltando
am i dying	estou morrendo
youre old	você é velho
nobody cares	ninguém se importa
slow down	vá mais devagar
its late	está tarde
is tom awake	o tom está acordado
are you happy	você é feliz
dont argue	não discutam
how nice	que legal
i dont work	eu não trabalho
it suits me	isso me serve bem
i saw tom	eu vi o tom
dont laugh	não rias
its too hot	está quente demais
im busy	estou ocupada
excuse me	perdão
sign this	assine
here or to go	é para comer aqui ou para levar
i do like tom	gosto muito do tom
describe tom	descrevam o tom
thats true	é verdade
release him	liberteo
she sued him	ela o processou
i told tom	eu disse a tom
are you going	você está indo embora
we remember	nós nos lembramos
tom saved me	tom me salvou
i like them	eu gosto deles
i wont bite	eu não irei morder
its tom	é o tom
youre safe	tu estás seguro
dogs can swim	cachorros sabem nadar
what a phony	que hipócrita
were angry	nós estávamos bravos
theyre bad	eles são ruins
thats his	é dele
this stinks	isto fede
it is not so	não é assim
we are sick	nós estamos doentes
i disagreed	eu discordei
be objective	seja objetiva
how do you do	como você está
kiss me	me beija
i promised	prometi
tom talked	tom falou
wont you go	você não vai
how arrogant	que arrogante
he is eight	ele tem oito anos de idade
you made it	você conseguiu
it was ok	foi bonzinho
get started	comece
i wont run	eu não vou correr
youre tired	você está cansado
he kicked it	ele chutou
ive decided	eu decidi
im going	estou indo
its garbage	é lixo
math is hard	matemática é difícil
get down	desça
were lost	estamos perdidos
im a klutz	eu sou um desastrado
dont scream	não grites
im sad	estou triste
this is tom	esse é o tom
im untidy	sou desorganizado
stay away	fique longe
are you okay	você está bem
tom prepaid	tom preparou
im bossy	eu sou mandona
jump	pule
she can swim	ela consegue nadar
i know tom	conheço o tom
choose one	escolha um
take care	se cuida
start again	comece de novo
youre late	você está atrasado
be serious	fiquem sérios
get some rest	descansem um pouco
tomll talk	tom irá falar
im now	eu tenho anos agora
all is still	tudo está quieto
id buy that	eu compraria aquilo
i like milk	eu gosto de leite
watch this	observem isto
theyre in	elas estão dentro
nice timing	na mosca
i belong here	meu lugar é aqui
im kidding	eu estou brincando
they saw tom	ele viram tom
pick that up	pegue aquele
ill do this	eu vou fazer isso
im better	eu sou melhor
i understand	eu entendo
i do want it	quero muito
i loved you	ameio
i was lost	eu estava perdido
its toms	é do tom
call security	chamem a segurança
now i get it	agora eu entendi
youre cute	você é bonita
can you drive	vocês sabem dirigir
it was a bet	era uma aposta
we need them	nós precisamos delas
here i am	aqui estou
anything new	algo de novo
im your age	tenho a sua idade
tom took it	o tom pegou
dont go away	não vá embora
is he busy	ele está ocupado
were sorry	nos desculpe
they voted	elas votaram
is it cancer	é câncer
its a steal	é um roubo
are you blind	você é cego
ill go home	eu vou para casa
i do like you	eu gosto de você de verdade
i pay taxes	eu pago os impostos
hold the rope	segurem a corda
im bald	sou careca
is it toms	isso é do tom
seize him	agarreo
who did it	quem o fez
is it bad	é grave
i will work	eu vou trabalhar
lighten up	relaxa
i walk fast	eu ando rápido
stop trying	parem de tentar
run	corra
try again	tente de novo
i hate rats	eu odeio ratos
tom will die	tom vai morrer
you must eat	você deve comer
do your best	faça o seu melhor
is it there	está lá
is he tom	ele é o tom
i want one	eu quero um
kiss me	beijeme
i have twins	eu tenho gêmeos
let me alone	me deixa quieto
ask mary out	chame a mary para sair
was i wrong	eu estava errado
tom is sad	tom está triste
i am a nurse	eu sou enfermeiro
pardon me	o que você disse
ask tom	peça para o tom
how far is it	quão distante é
of course	pois sim
im bluffing	estou blefando
they walked	caminharam
i had doubts	eu tinha dúvidas
im adopted	eu sou adotado
we all know	todos nós sabemos
is it good	é bom
lets try it	vamos tentar
it was worse	foi pior
please stay	por favor fique
help us	nos ajude
stop tom	impeçam o tom
im starving	estou faminto
who came	quem veio
i fooled tom	eu enganei tom
come anytime	venha a qualquer hora
ill kill it	eu o matarei
get dressed	vistamse
he seems kind	ele parece ser gentil
i was wet	eu estava molhada
ask anybody	pergunte a alguém
i can make it	posso fazêlo
im ugly	sou feio
tom said yes	o tom disse que sim
keep it	fique com ela
ask around	pergunte por aí
hang on	aguardem
i took a cab	eu peguei um táxi
were saved	estamos salvos
youre old	os senhores são velhos
im at home	estou em casa
im horrible	sou horrível
tom wants it	tom quer isso
i was bored	eu estava entediado
they waited	eles esperaram
toms stoned	tom está chapado
im puzzled	eu estou intrigado
whos here	quem está aqui
thats a lot	é muito
im working	estou trabalhando
theyre boys	são meninos
youll do it	vocês vão fazer
well start	nós vamos começar
i had to go	tive que ir
nobody slept	ninguém dormiu
hes very ill	ele está muito doente
can tom cook	o tom sabe cozinhar
i have news	tenho novidades
it scares me	isso me assusta
this is gold	isso é ouro
i hope i win	eu espero que eu ganhe
anybody hurt	alguém machucado
i got mad	eu fiquei furioso
im not bald	não sou careca
get away	cai fora
i dont mind	eu não ligo
trust tom	confie em tom
get out	saia daqui
he looks pale	ele parece pálido
stop yelling	para de gritar
do you drink	você bebe
are you ok	você está bem
go find tom	vai encontrar tom
take it	peguemno
im upset	estou chateado
tom said yes	tom disse sim
my eyes hurt	doemme os olhos
are you well	você está bem
hurry up	apressate
they laughed	eles riram
hes asleep	está adormecido
its a curse	é uma maldição
fish please	peixe por favor
i got hit	fui atingido
he loves her	ele a ama
tom is in	tom está dentro
im stuck	eu estou presa
it was here	estava aqui
is it for me	isso é para mim
see you soon	até logo
dogs bark	cães latem
answer me	respondamme
toms dying	tom está morrendo
do you smoke	você fuma
tom is dying	tom está morrendo
i am here	eu estou aqui
i saw a ufo	eu vi um objeto voador não identificado
what a woman	que mulher
thats cruel	isso é cruel
settle down	acalmese
tom promised	tom prometeu
what a day	que dia
hes coming	ele está chegando
tom came	tom veio
tom shot her	tom atirou nela
i eat here	eu como aqui
go away	vá embora
we love tom	nós amamos o tom
im thirsty	tenho sede
grab my hand	segure a minha mão
have fun	divirtamse
they called	eles ligaram
stand aside	afastese
im with tom	eu estou com o tom
im done	já terminei
they escaped	eles escaparam
i wont die	não vou morrer
you survived	você sobreviveu
its for you	isso é para você
i sympathize	me simpatizo
i live alone	eu moro sozinho
mary giggled	maria deu risadinhas
stop that	pare com isso
you go first	tu primeiro
itll happen	isso irá acontecer
you may stay	o senhor pode ficar
tom liked it	tom gostou
think again	pensa de novo
tom sweated	tom suava
i dont agree	eu discordo
were calm	estamos calmos
welcome	seja bemvindo
look back	olhem para trás
theyll fail	eles fracassarão
we forgot	esquecemos
join us	juntese a nós
how wonderful	que maravilha
tom vanished	tom desapareceu
be objective	seja objetivo
tom got mad	tom ficou furioso
youre lucky	você é sortudo
i found it	encontrei
how are you	quem és tu
who drew it	quem desenhou
tom is lazy	tom é preguiçoso
we know that	sabemos disso
go to sleep	vá dormir
marry me	case comigo
turn right	dobre à direita
i talked	eu falei
do i look fat	eu pareço gorda
is it blue	é azul
were hungry	estamos famintos
goodbye	até a vista
hes strong	ele é forte
did tom call	tom ligou
are you sure	você tem certeza
were free	estamos livres
toms fast	tom é rápido
sleep tight	durma bem
well go out	vamos sair
step aside	afastese
well cook	nós cozinharemos
all aboard	todos a bordo
toms asleep	o tom está dormindo
were lost	estamos perdidas
go for it	vá em frente
wake up	acordem
sit there	sentese aí
ask tom	peça ao tom
dont laugh	não ria
am i wrong	estou errado
i had help	eu tive ajuda
im trapped	estou preso
they gave up	eles desistiram
lets see it	vamos ver
i am all ears	sou todo ouvidos
dont be late	não se atrase
thank you	obrigada
im trapped	eu estou presa
im fat	eu sou gorda
tom walked	tom caminhou
he kissed her	ele a beijou
its broken	está quebrado
were ready	nós estamos prontos
were coming	nós estamos vindo
tom is next	tom é o próximo
dont move	não se mexa
well shoot	nós vamos atirar
dont sing	não cante
it was dark	estava escuro
tell me more	conteme mais
im dyslexic	eu sou disléxico
it was night	era noite
i phoned him	liguei para ele
i was good	eu era bom
i nailed it	está no papo
tom will go	tom irá
be serious	fica sério
wonderful	que maravilha
does it work	isso funciona
shut it down	desliga
anything else	mais alguma coisa
i fired tom	eu demiti tom
how barbaric	que bárbaro
i know tom	eu conheço o tom
were armed	nós estamos armados
it will burn	isso vai queimar
it hurts	isso machuca
theyre ugly	eles são feios
im next	sou a próxima
stay focused	mantenhase focado
you may stay	podes ficar
i cried today	eu chorei hoje
listen	escutem
im bald	estou careca
i feel sick	sintome mal
can tom drive	tom sabe dirigir
follow him	sigamno
i need mine	preciso da minha
who am i	quem sou eu
tom is weird	o tom está estranho
im reserved	eu sou reservado
it is my cat	é o meu gato
i resign	eu me demito
you may stay	podem ficar
theyre gone	elas foram embora
it is dusty	está empoeirado
tom crashed	tom sofreu um acidente
fire	fogo
help me	me ajuda
i am happy	eu estou feliz
she smiled	ela sorriu
i went twice	eu fui duas vezes
come get some	venha pegar algumas
hey relax	ei relaxa
im a hero	sou um herói
dont be evil	não seja mau
find tom	encontrem o tom
cut it out	para com isso
stop tom	pare o tom
im curious	eu sou curiosa
leave me	me deixa
i smiled	dei um sorriso
leave us	nos deixe
why me	por que eu
im with tom	estou com o tom
youre nuts	estás maluco
please stay	fique por favor
i agreed	eu concordo
warn tom	alerte o tom
lets split	vamos dividir
birds sing	pássaros cantam
who are they	quem são elas
are they tall	elas são altas
its a tv	isso é uma tv
i got mad	fiquei furioso
well start	vamos começar
ive won	eu venci
we are men	nós somos homens
run	corram
who ran away	quem fugiu
lets party	vamos festejar
well done	bom trabalho
anybody home	tem alguém em casa
he wont know	ele não vai saber
youre fair	você é justo
stop it	para com isso
are you	você tem anos de idade
i am smart	eu sou inteligente
i want one	eu quero uma
theyll call	eles vão chamar
ask them	pergunte para eles
tom enlisted	tom se alistou
go to school	vá para a escola
its done	está pronto
its over	acabou
go to school	vai à escola
pardon me	perdão
we promised	prometemos
tom is nuts	tom está com um parafuso solto
be creative	sede criativos
well start	nós começaremos
shes pretty	é bonita
smile	sorriam
i studied	eu estudei
heres	aqui estão
im fat	sou gordo
wonderful	magnífico
you hurt me	você me machucou
come off it	desista
is tom ok	o tom está bem
open up	abra
tom can talk	tom sabe falar
have some	peguem um pouco
what else	o que mais
i set a trap	eu coloquei uma armadilha
he likes tea	ele gosta de chá
be prepared	esteja preparada
i love bread	eu amo pão
im hurt	estou ferido
they are big	elas são grandes
i am coming	eu estou vindo
ill get ice	eu vou pegar gelo
i have a cat	eu tenho um gato
are you well	vocês estão bem
i am coming	eu estou chegando
i need sugar	preciso de açúcar
check that	verifique isso
set tom free	liberte tom
ill get ice	vou pegar gelo
where is he	onde ele está
be merciless	seja piedosa
i laughed	eu ri
is it yours	isso é seu
were rich	nós somos ricos
its a steal	isso é um roubo
its my book	este é meu livro
time is up	o tempo acabou
ive failed	eu fracassei
its ok	está bem
youre old	tu és velha
im retired	eu estou aposentado
ask anybody	perguntem a alguém
were happy	nós somos felizes
tea please	chá por favor
i was robbed	eu fui roubado
tom is old	o tom é velho
im sorry	lamento
tomll speak	tom vai falar
dont wait	não espere
youre next	você é o próximo
i hate chess	eu detesto o xadrez
wake up	acorde
its so sad	é tão triste
tom winked	o tom piscou
tom wants it	tom quer
pray for me	rezem por mim
keep it up	continua
drive faster	dirija rápido
can i help	posso dar uma mãozinha
i cant fly	não consigo voar
see you	nos vemos
you may stay	você pode ficar
im alone	estou sozinho
i need space	preciso de espaço
come in	entre
wait a while	esperem um momento
are they dead	eles estão mortos
theyre evil	eles são maus
goodbye	até logo
i have proof	eu tenho prova
kiss me	dême um beijo
years passed	passaram os anos
how do you do	como vai
has she come	ela veio
stay still	não se mova
please hurry	por favor apressemse
let me out	deixeme sair
thatll do	isso vai servir
goodbye	até o rever
we miss you	sentimos saudades de você
is tom in	o tom está dentro
dont scream	não grite
here she is	aqui está ela
tom is a spy	o tom é espião
i love golf	eu adoro golfe
answer me	respondame
its poison	é veneno
we apologize	nós desculpamos
thank you	obrigado
i teach here	eu leciono aqui
many thanks	muito obrigada
stand up	levantese
youre shy	você está tímido
go home	vá para casa
go without me	vá sem mim
tom is picky	tom é exigente
stand by	aguardem
say cheese	sorria
are you free	está livre
youre old	os senhores estão velhos
ill shoot	eu vou atirar
she tried	ela tentava
im decisive	sou decisivo
cheer up	ânimo
now leave me	agora me deixe
come over	venha
toms angry	tom está nervoso
i hope i win	eu espero que eu vença
youre fired	você está despedido
i am a cook	eu sou cozinheiro
attack	ataquem
cut it out	parem com isso
hug tom	abrace o tom
im thirty	eu tenho trinta anos
look back	olhem para trás
was it cold	era frio
hold the door	segure a porta
it was tom	era o tom
toms hungry	tom está com fome
hang on	aguarde
youre shy	vocês estão tímidas
its cool	é legal
go away	vá embora
dont smile	não sorrias
youre cute	o senhor é bonito
come out here	vem aqui
let me try	deixeme tentar
do as he says	faz como ele diz
did tom come	tom veio
how deep	qual a profundidade
go inside	entra
we laughed	nós rimos
hes cruel	ele é cruel
are you tired	vocês estão cansadas
can you hear	consegue ouvir
im not in	não estou dentro
i need that	eu preciso disso
be discreet	sê discreta
i cry easily	eu choro facilmente
i should go	eu deveria ir embora
i read a lot	eu leio muito
toms skiing	tom está esquiando
its stupid	isso é estúpido
are they gone	eles se foram
are you tired	vocês estão cansados
take cover	protejamse
im not rich	eu não estou rico
im angry	estou com raiva
i can swim	eu sei nadar
did tom go	o tom foi
ill leave	vou embora
go away	fora
im free now	eu estou livre agora
its nothing	isso não é nada
tom is pushy	tom é agressivo
we found one	nós encontramos um
do you get me	você me compreende
hi	oi
i do hope so	realmente espero
theyre kids	elas são crianças
im right	eu estou certo
ill do that	farei isto
help us	ajudenos
hes lying	ele mente
i said maybe	eu disse talvez
i need a map	preciso de um mapa
tom burped	tom arrotou
what is love	o que é o amor
shut up	calem a boca
im a vegan	eu sou vegano
lets begin	comecemos
dont worry	não se preocupe
is this love	isso é o amor
i like that	eu gosto disso
leave it	deixe para lá
tom is witty	tom é espirituoso
you won	você venceu
toms not in	tom não está dentro
tom was sad	o tom estava triste
im freezing	estou congelando
i was there	eu estava lá
forget it	esquece
i like rice	eu gosto de arroz
i whistled	eu assobiei
thats cool	isso é legal
tom is there	o tom está lá
ignore them	ignoremnas
come back now	agora volte
tom called	tom ligou
wash up	lave as mãos
i need a bag	preciso de uma bolsa
stop tom	parem o tom
wait outside	espere lá fora
its his	é dele
im hungry	estou com fome
watch this	olhe isso
i go to work	vou ao trabalho
im tall	eu sou alto
can you swim	sabes nadar
i want tom	eu quero o tom
it is	são sete e quarenta e cinco
keep quiet	fique quieta
im in perth	estou em perth
keep walking	continuem caminhando
we apologize	desculpamos
im innocent	eu sou inocente
i wont bite	não irei morder
i stopped	eu parei
got it	eu entendi
ill pay	eu pagarei
well stand	nós estaremos de pé
call us	ligue para a gente
tom told him	tom contou para ele
we are happy	somos felizes
i love rock	eu gosto de rock
drop it	solteo
dont sing	não cantes
youre old	vocês são velhos
turn it over	vire ao contrário
im thirsty	estou sedento
tom has it	o tom tem isso
i am single	sou solteiro
abandon ship	abandonar o navio
its a tv	é uma tv
well attack	nós vamos atacar
dont leave	não saia
could we sit	poderíamos sentar
wholl drive	quem vai dirigir
thats tom	esse é o tom
grab him	agarremno
i am a man	eu sou homem
i left	eu saí
im a father	eu sou um pai
i am online	eu estou online
i hate opera	eu odeio ópera
i cried	eu chorei
can i hug you	posso abraçálo
have another	tomem outra
i have a son	tenho filho
i looked	eu olhei
stop talking	pare de falar
i shoved tom	eu empurrei o tom
we had fun	nós nos divertimos
ill see tom	eu verei o tom
tom fired me	o tom me despediu
i made a bet	eu fiz uma aposta
keep working	continuem trabalhando
im tidy	estou arrumado
i may win	eu posso ganhar
im thirsty	estou com sede
how are you	como você está
im naive	eu sou ingênuo
mary is mine	mary é minha
come quickly	vem logo
i need a job	preciso de um trabalho
dont move	não se mova
help	ajuda
im thinking	estou pensando
ive decided	decidi
stay down	fiquem abaixados
i missed you	senti saudade
its done	está pronta
its too far	isto está longe demais
are you sure	tem certeza
i felt that	eu senti aquilo
thats me	sou eu
they yelled	eles gritaram
they swam	eles nadaram
this is it	é isso
beef please	carne por favor
tom cried	tom chorou
i prayed	eu orei
i need you	eu preciso de vocês
birds fly	os pássaros voam
go away	se manda
burn the body	queime o corpo
here we are	eisnos aqui
i see	estou vendo
we are arabs	somos árabes
i am full	estou cheio
you may swim	pode nadar
i have ocd	eu tenho toc
lets start	vamos começar
talk to tom	conversa com o tom
ill be late	eu vou me atrasar
please hurry	despachemse por favor
is this mine	essa é minha
im tidy	eu estou arrumado
dont mind me	não ligue para mim
we like it	nós gostamos
im afraid	estou com medo
i know you	eu te conheço
tom woke up	tom acordou
i like chess	gosto de xadrez
everyone dies	todo mundo morre
i will help	eu vou ajudar
what a jerk	que idiota
bring my hat	traga o meu chapéu
they kissed	eles se beijaram
i feel sick	estou mal
thats true	isso é verídico
i have a son	eu tenho um filho
youve won	você ganhou
he is english	ele é inglês
he runs fast	ele corre rápido
tom is home	tom está em casa
im escaping	eu estou fugindo
are you a fan	você é um fã
i hate rules	eu odeio regras
hows tom	como tom está
am i included	eu estou incluído
write me	escrevame
theyre here	elas estão aqui
toms crying	tom está chorando
stop here	pare aqui
im not old	eu não sou velho
tomll come	tom virá
i am chinese	eu sou chinês
dont argue	não discuta
are we alone	nós estamos sozinhos
were happy	somos felizes
they danced	dançaram
act your age	aja de acordo com a sua idade
i confessed	eu confessei
i cant win	eu não consigo vencer
they know us	elas nos conhecem
cain was evil	cain era mau
its me	sou eu
seriously	é sério
i agree	eu estou de acordo
recess ended	o recreio terminou
tom is my ex	tom é meu ex
you go first	você primeiro
take mine	pegue a minha
he sells cars	ele vende carros
i like china	eu gosto da china
bring it here	traga isso aqui
im not free	não estou livre
listen up	escute
i didnt lie	eu não menti
be objective	sejam objetivos
ill go back	eu voltarei
dont ask me	não me pergunte
whos next	quem é o próximo
ill cook	cozinharei
hang on tight	segurem firme
its a plant	é uma planta
hurry up	apressese
i was happy	eu era feliz
dont laugh	não ria
we want it	nós queremos isso
dont rush me	não me empurre
tom told us	tom nos contou
i love rock	eu amo rock
i do like you	eu gosto muito de vocês
tom is nuts	tom tem um parafuso solto
turn around	dê uma volta
is tom busy	tom está ocupado
wow	uau
i saw him	eu o vi
i can wait	eu posso esperar
tell tom why	diga a tom o porquê
forget it	deixa
try some	experimentem
we trust him	confiamos nele
who	quem
i overslept	eu dormi demais
im broke	estou sem dinheiro
he kicked it	ele o chutou
we talked	nós conversamos
be patient	tenha paciência
who listened	quem escutou
he needs you	ele precisa de você
ill do this	vou fazer
dont worry	não se preocupe
keep out	não entre
tom has left	tom foi embora
i bribed them	eu os subornei
dont respond	não respondas
we know	nós sabemos
shut it off	desligueo
did tom cry	o tom chorou
ignore them	ignoreos
i know	eu sei
toms groggy	tom está grogue
hold on to me	segurese em mim
be tolerant	sejam tolerantes
help me	me ajuda
follow me	sigame
tom changed	tom mudou
do i know tom	eu conheço tom
get down	abaixese
im prepared	estou preparado
its okay	está bem
tom fought	tom lutou
drop it	largue isso
hug tom	abracem o tom
toms asleep	tom está dormindo
trust in me	confia em mim
here or to go	é pra comer aqui ou para levar
youre nuts	estás maluco
can i do this	posso fazer isso
come soon	venha logo
we waited	esperamos
get up	levantese
come quickly	vem logo
he walks fast	ele anda rápido
stay focused	se mantenha focado
be discreet	sede discretos
its fine	está bem
did we win	vencemos
he stood up	ele se levantou
he was crying	ele estava a chorar
you may stay	a senhora pode ficar
i got fired	eu fui demitido
i got lost	eu me perdi
all is well	está tudo bem
dont ask	não pergunte
pray for me	reze por mim
she cried	ela chorou
are you tall	você é alta
its ok	está tudo bem
are you crazy	estás louco
is tom there	o tom está lá
they waited	esperaram
tom saw them	tom viu eles
walk slowly	ande devagar
i forgot it	me esqueci disso
tom told me	tom me disse
i suppose so	suponho que sim
hi everybody	olá pessoal
let me see	deixame ver
come inside	entrem
dont push me	não me empurre
he is heroic	ele é heroico
he has guts	ele tem culhão
i ate apples	eu comi maçãs
let me die	deixemme morrer
the tvs on	a televisão está ligada
tom has time	tom tem tempo
i have plans	eu tenho planos
im in bed	estou na cama
toms strong	tom é forte
i can feel it	posso sentila
i can run	eu posso correr
i am a monk	sou um monge
im jealous	eu sou ciumento
you are ugly	você é feia
i understand	entendo
youre old	vocês estão velhos
are you happy	você está feliz
tom is fine	o tom está bem
try it	tentao
well wait	esperaremos
tom is tired	o tom está cansado
i yawned	eu bocejei
its new	isso está novo
how are you	como vai
who told you	quem lhe contou
sit down	sentese
keep it	fiquem com ele
well see	nós veremos
im correct	eu tenho razão
are you hurt	você está ferido
we can do it	podemos fazer isso
can tom walk	o tom sabe andar
i ran home	corri para casa
i needed tom	eu precisava de tom
keep writing	continue escrevendo
ill try	tentarei
they said no	eles disseram que não
are you a fan	tu és um fã
youre lost	você está perdido
come in	entre
youre cute	a senhora é bonita
were tired	nós estamos cansados
what is it	o que é
i need a car	eu preciso de um carro
you may swim	podem nadar
im crazy	estou bravo
can i do this	consigo fazer isso
cool down	acalmese
youre fired	você está despedida
tom lies	tom mente
theyre kids	são crianças
you scare me	vocês me assustam
youre right	você está certo
i dont read	eu não leio
thanks	obrigado
im going	já vou
ghosts exist	fantasmas existem
i found it	encontreia
answer tom	responda ao tom
ask tom	pergunta para o tom
im blind	eu sou cega
it will work	vai funcionar
have another	toma outra
im confused	estou confuso
i am hungry	estou faminto
stay with us	fique conosco
go find tom	vai achar o tom
i need a job	eu preciso de um trabalho
i found you	eu encontrei você
have another	tome outra
tom quit	tom desistiu
never mind	tudo bem
is tom here	tom está aqui
tom sighed	tom suspirou
im hot	estou com calor
i built it	eu o construí
tom gasped	tom arfou
we watch pbs	assistimos pbs
help tom	ajuda o tom
open the box	abre a caixa
theyll grow	eles crescerão
look there	olha lá
hes a sexist	ele é sexista
we were busy	nós estávamos ocupados
im inside	eu estou dentro
well share	nós vamos compartilhar
i like fruit	eu gosto de frutas
mary is tall	mary é alta
abandon ship	abandonar o navio
wait in here	espere aqui
im not ugly	não sou feio
i hate sand	eu odeio areia
we won	nós vencemos
i see that	estou vendo
im a woman	sou mulher
i feel tired	sintome cansado
no way	impossível
were weak	nós estamos fracos
i want soup	eu quero sopa
keep it	fica com ela
she is old	ela é velha
choose one	escolha uma
it was toms	era de tom
we surrender	nós desistimos
ill sue you	eu vou te processar
tom can win	tom pode ganhar
look closely	olhe de perto
im faster	eu sou mais rápida
i feel dizzy	estou tonto
be careful	toma cuidado
dont leave	não saia
im not done	eu ainda não estou pronto
take a rest	descansem
youre sick	você está doente
its a gift	é um presente
tom vomited	o tom vomitou
i apologize	perdão
he ate out	ele comeu fora
be sensible	tende bom senso
i blinked	eu pisquei
be fair	sê justo
i need space	eu preciso de espaço
i will wait	irei esperar
im drunk	estou embriagado
do you mind	você se importa
tom agreed	tom concordou
im drunk	estou bêbada
take mine	pegue o meu
once again	mais uma vez
am i hired	estou contratado
its monday	é segundafeira
thats mine	isso é meu
get up	levantate
i whistled	eu dei um assobio
turn it off	desligueo
whats up	e aí
take it all	leve tudo
tom yelled	tom gritou
come tomorrow	venha amanhã
i ran	eu corri
i am tired	estou cansado
i didnt care	eu não me importo
youre shy	vocês são tímidas
must i hurry	devo me apressar
come to us	venha até nós
do fish sleep	os peixes dormem
stop them	detenhanos
it is unfair	isso é injusto
have a look	dá uma vista de olhos
i won	eu venci
is this cool	isto é legal
im with tom	estou com tom
get serious	fique sério
dont push	não empurrem
ill stay	eu vou ficar
years passed	anos se passaram
i like snow	eu gosto de neve
war is hell	a guerra é um inferno
we miss tom	sentimos saudades do tom
you must go	tu deves partir
i was wrong	eu estava errado
stop lying	pare de mentir
why not	por que não
go inside	entre
i disagree	eu discordo
will he die	ele morrerá
im horrible	eu estou horrível
he was alone	ele estava só
sit tight	peraí
were calm	nós somos tranquilos
this is mine	isto é meu
stay here	fique aqui
look at him	olhe para ele
im punctual	sou pontual
tom listened	tom escutou
i was hired	eu fui contratado
tom hates tv	tom detesta tv
im rich	eu sou rico
tom shaved	tom barbeouse
it may rain	pode chover
im furious	estou furiosa
have a cookie	come um biscoito
whats new	que há de novo
im a doctor	sou médico
dont fight	não lute
he is french	ele é francês
ask an expert	pergunte a um especialista
i said yes	disse sim
you are ugly	você é feio
toms sick	tom está doente
can i hug you	posso te dar um abraço
i want that	eu quero isso
im so bored	estou muito entediado
hes happy	ele é feliz
im wealthy	eu sou rico
dont risk it	não se arrisque
dont get mad	não fique bravo
she is lucky	ela tem sorte
toms crazy	o tom é louco
i handled it	eu lidei com isso
im sleeping	estou dormindo
go ahead	continua
hes stupid	ele é estúpido
unbelievable	inacreditável
hows the dog	como o cachorro está
toms deaf	tom é surdo
come home	venha para casa
do you agree	vocês concordam
tom drowned	tom se afogou
let me leave	deixeme ir embora
tom voted	tom votou
i fear so	eu temo que sim
we all cried	todos nós choramos
ive done it	eu o fiz
is tom out	o tom está fora
dont rush me	não me empurrem
i found it	encontrei
nice shot	belo tiro
hey relax	ei relaxem
weve won	vencemos
im cool	sou legal
watch this	veja isto
im mature	eu sou maturo
ill call	ligarei
tom swore	tom jurou
youre scary	tu és assustador
how are you	como vai você
listen	ouça isso
i went too	eu fui também
tom is on tv	tom está na tv
i can cook	eu posso cozinhar
wait outside	esperem lá fora
well go out	nós vamos sair
did tom help	o tom ajudou
hello girls	olá meninas
stay cool	fique calmo
tom is a pig	tom é um porco
i was fired	eu fui demitido
kiss me	me beije
come over	vem
follow tom	sigam o tom
im involved	estou envolvido
well win	nós venceremos
work slowly	trabalhe devagar
were free	somos livres
please sit	por favor sentemse
he is drunk	ele está bêbado
ill do this	eu vou fazer
you fainted	vocês desmaiaram
keep calm	acalmese
you idiot	seu idiota
he resigned	ele renunciou
how wonderful	maravilhoso
thats mine	é meu
come here	vem cá
i bit my lip	eu mordo o lábio
were dating	estamos namorando
they escaped	escaparam
he cant swim	ele não sabe nadar
run and hide	corra e escondase
i love you	eu te amo
hes wet	ele está molhado
theyre gone	elas se foram
stay with us	fiquem conosco
who is she	quem é ela
they hate me	elas me odeiam
does tom know	tom sabe
we survived	sobrevivemos
stay calm	fique calma
save tom	salve o tom
i love cats	adoro gatos
wood burns	a madeira queima
try it on	experimenteo
do as i asked	faça como eu pedi
he has come	ele veio
aim fire	preparar apontar fogo
i wont lose	eu não vou perder
drive safely	dirija com cuidado
lets review	vamos revisar
be realistic	seja realista
hurry up tom	apressese tom
its free	é de graça
i hate this	eu odeio isto
they came in	eles entraram
come over	venham
i like rice	gosto de arroz
youre kind	você é simpático
youre shy	vocês são tímidos
i am in pain	estou com dor
sign this	assinem isso
toms young	o tom é jovem
come along	vem com a gente
flowers bloom	flores florescem
beware of dog	cuidado com o cão
go ahead	continuem
are you crazy	você é louco
theyre evil	elas são más
this is big	isto é grande
i almost won	eu quase ganhei
come with us	venha com a gente
tom is happy	tom está feliz
i waved	eu acenei
i have a car	eu tenho um carro
my jaw hurts	minha mandíbula dói
tom decided	tom decidiu
watch tom	olha o tom
well obey	nós obedeceremos
go ahead	continue
ill pay you	eu vou te pagar
i will try	eu vou tentar
dont move	não se mexa
unbelievable	incrível
im ready	estou pronta
it stinks	isso fede
im old	eu sou velho
ignore him	ignoreo
that was odd	foi estranho
ill try it	eu vou tentar
is this tom	este é tom
toms angry	tom está com raiva
vote for me	vote em mim
were lazy	nós somos preguiçosas
lets swim	vamos nadar
ill decide	decidirei
its for me	isso é para mim
be tolerant	sê tolerante
come with me	venha comigo
look out	atenção
its hers	isso é dela
is this mine	esse é o meu
hang on tight	segurese firme
tom teaches	tom ensina
i need help	preciso de ajuda
are you upset	você está triste
youve won	você venceu
leave town	deixe a cidade
i dont care	não estou nem aí
im popular	eu sou popular
this is hard	isto é difícil
youre wrong	você está errado
hes smart	ele é inteligente
keep back	afastese
hey dont go	ei não vá
excuse me	com licença
everyone wins	todo mundo sai ganhando
dont be long	não demore
i love her	eu a amo
stay down	fique abaixado
lets play	vamos tocar
bring the key	traga a chave
did tom fall	o tom caiu
youre gross	você é nojento
i did my best	eu fiz o meu melhor
you may stay	pode ficar
taste this	provem isto
fight or die	lute ou morra
ill pay you	irei te pagar
its open	está aberto
i tripped	tropecei
are you brave	você é corajoso
can he do it	ele sabe fazer isso
dont push me	não me empurra
thanks	obrigado
is this true	é verdade
you need me	vocês precisam de mim
tom hates it	o tom odeia isso
i met a girl	eu conheci uma garota
tom is short	o tom é baixo
nobody died	ninguém morreu
let me speak	deixeme falar
come closer	cheguem mais perto
its red	é vermelho
could i do it	eu poderia fazer isso
its done	pronto já está
i need a hug	preciso de um abraço
this is nice	isso é legal
tom is rich	tom é rico
i am busy	estou ocupado
is it a wolf	isso é um lobo
we sat down	nos sentamos
tom grinned	tom sorriu forçadamente
tom escaped	tom escapou
well sing	cantaremos
tomll know	tom vai saber
speak up	falem mais alto
i cant sleep	não consigo dormir
how absurd	que absurdo
im back	voltei
no kidding	sem brincadeira
where is she	cadê ela
ill get up	vou me levantar
im out here	estou aqui fora
tomll lose	tom vai perder
come anytime	venha quando quiser
we got ready	nós nos preparamos
is this ok	está ok
was tom busy	tom estava ocupado
im a farmer	sou um fazendeiro
dont do it	não faça isso
how cute	que fofinho
i will learn	vou aprender
do you drink	vocês bebem
i hope so	assim espero
this is easy	isto é fácil
youre cute	as senhoras são bonitas
itll work	isso vai funcionar
how cute	que bonitinho
tom is calm	tom é calmo
i need money	necessito de dinheiro
sweet dreams	bons sonhos
were sleepy	nós estamos com sono
try hard	se esforça
he was alone	ele estava sozinho
boys run fast	os meninos correm rápido
i need a job	eu preciso de um emprego
can you swim	sabe nadar
i am working	eu estou trabalhando
cool down	acalmemse
pick it up	apanheo
toms ugly	tom é feio
we know why	sabemos por quê
we knew this	nós sabíamos disso
i washed it	eu o lavei
he is happy	ele é feliz
i am like him	eu sou como ele
they won	eles venceram
keep reading	continue lendo
how tragic	que trágico
is tom drunk	o tom está bêbado
lets go eat	vamos comer
im hot	tenho calor
he is alone	ele está sozinho
cain was evil	cain era malvado
how lovely	que amável
ill win	vou vencer
ill get you	vou te pegar
take it easy	acalmese
take tom	leva o tom
toms gone	tom se foi
im the best	eu sou o melhor
tom is mad	tom está insano
were crazy	a gente é maluco
shut up	cala a boca
i will learn	eu aprenderei
i also went	eu também fui
dont ask	não pergunte
contact tom	contacte o tom
contact tom	contactem o tom
youre old	sois velhas
thats true	isso é verdade
have courage	tenha coragem
were hiding	nós estamos nos escondendo
it isnt tom	esse não é o tom
i hate milk	eu odeio leite
go get a beer	vá pegar uma cerveja
start now	comece agora
can we talk	podemos conversar
we need time	precisamos de tempo
toms alive	tom está vivo
start again	começa de novo
im tired	estou cansado
my eyes itch	meus olhos coçam
i have cash	eu tenho dinheiro
you idiot	idiota
are you tired	você está cansada
memorize it	memorize
dont be evil	não seja má
i feel lost	eu me sinto perdido
we agreed	nós concordamos
its too big	é muito grande
im winning	estou vencendo
well try	a gente vai tentar
tom cares	tom se importa
i want a dog	eu quero um cachorro
im broke	estou quebrado
i like that	curto isso
well win	venceremos
are you ok	vocês estão bem
nobody came	não veio ninguém
ignore them	ignoreas
i am single	estou solteiro
get some rest	descanse um pouco
i was bored	eu estava entediada
have fun	divertete
i just ate	acabei de comer
im sorry	me desculpe
im hungry	quero comer
keep it	fiquem com ela
ive no idea	não tenho ideia
i must study	eu preciso estudar
i need more	preciso de mais
im fighting	eu estou lutando
tom refused	tom recusou
im broke	eu estou duro
tom is weak	tom é fraco
i slipped	eu escorreguei
am i early	cheguei cedo
im busy	estou ocupado
i was sick	eu estava doente
they fell	sentiram
whats wrong	o que está errado
tom felt sad	tom se sentiu triste
is it for me	é para mim
youre wise	você é sábio
i saw that	eu vi
get real	acorda
keep digging	continuem cavando
youre old	você é velha
hes too busy	ele está muito ocupado
we remember	nós lembramos
get out	saia
im fine now	eu estou bem agora
go on	vá
youre brave	você é valente
i was hiding	eu estava me escondendo
im a vegan	eu sou vegana
it helps	isso ajuda
tom failed	tom falhou
im through	acabei
youre shy	você está tímida
help me tom	ajudeme tom
well wait	nós vamos esperar
im special	eu sou especial
tom tripped	tom disparou
well scream	nós vamos gritar
tom told us	tom nos disse
i laughed	ri
attack	atacar
help me	ajudeme
get a move on	mexase
it happens	isso acontece
wake up	acordem
im a farmer	eu sou um agricultor
wake up tom	acorda tom
i need air	eu preciso de ar
get down	deitemse
are they gone	elas foram embora
theyre back	eles voltaram
am i right	eu estou certo
goodbye	tchau
tom will pay	tom vai pagar
i dont snore	eu não ronco
he can read	ele sabe ler
tom got sick	tom ficou doente
do it for tom	façam isso pelo tom
im like tom	eu sou como o tom
someone came	alguém veio
well attack	atacaremos
im managing	estou conseguindo
im lying	estou mentindo
im dieting	estou de dieta
what a pain	que dor
bring backup	tragam reforço
i like that	eu gosto disto
how pathetic	que patético
do it again	faz outra vez
i liked tom	gostei de tom
im thin	eu sou magro
help me out	ajudeme a sair
sing along	cante junto
hes not sick	ele não está doente
tom won	tom ganhou
did tom reply	o tom respondeu
i like girls	gosto de meninas
ill explain	explicarei
was she seen	ela foi vista
thats good	isso é bom
dont look up	não olhe para cima
he shot at me	ele atirou em mim
tom likes me	o tom gosta de mim
were late	estamos atrasados
give him time	dêlhe tempo
have another	tome outro
are you home	você está em casa
i dont dream	eu não sonho
tom waved	tom acenou
im hungry	estou faminto
i am a boy	eu sou um menino
i cut myself	eu me cortei
listen	escute
i am sure	tenho certeza
its locked	está trancado
look at that	olhe para aquilo
i believe tom	eu acredito no tom
he mocked me	ele zombou de mim
who escaped	quem escapou
i drank milk	eu bebi leite
did i win	eu ganhei
be still	acalmese
i keep a dog	eu tenho um cachorro
stop smoking	pare de fumar
call me later	me liga depois
look alive	se apresse
id buy that	eu compraria aquele
i have won	eu venci
youre old	você está velho
